gero_storjohann Ebenfalls frohe und gesunde Ostern ‚òÄÔ∏è	OTHER	OTHER
Still ruht der See k√∂nnte man meinen aber hinter den Kulissen wird emsig gearbeitet Das zeigt mein Wahlkreisbesuch vor Ort in Altenhof Wir haben das Privileg in einer Region zu leben in der andere gerne 	OTHER	OTHER
Der WDR nutzt das Propaganda-Narrativ von den 'demokratischen Parteien' minus AfD und demonstriert damit einmal mehr sein demokratieaverses Wesen Zu dem Kartell von CDUSPDFDPLINKEGR√úNE mu√ü man nichts mehr sagen das disqualifiziert sich von selbst	OFFENSE	OFFENSE
lhein77 takberlin AndreasS2904 spdbt ZDFheute Wer sonst	OTHER	OTHER
novoklar aufstehen_de Jeder kann das halten wie er/sie will Nur muss deswegen ja nicht die Krankenkasse f√ºr Placebos bezahlen w√§hrend arme Kinder das Brillengestell nicht mehr vern√ºnftig finanziert bekommen	OTHER	OTHER
Reffeff lillymu76 JRehborn flokerich spdbt Es hat nat√ºrlich keine Priorit√§t Trotzdem k√∂nnte man den Fachleuten und der Realit√§t mal Rechnung tragen und das abr√§umen Das Verbot hilft wirklich niemandem	OTHER	OTHER
NChiggi Wieso Frank Bsirske sitzt auch im Aufsichtsrat der Deutschen Bank	OTHER	OTHER
Weil die Kohlekraftwerke f√ºr mind 30 % der deutschen CO2-Emissionen verantwortlich sind kann man mit kleinen Fehlern beim Kohleausstieg so gro√üen Schaden anrichten Die freien Zertifikate m√ºssen auf jeden Fall gel√∂scht werden 	OTHER	OTHER
Einer der d√ºmmsten Reden ever im Bundestag N√ºchtern betrachtet ist der AfD Typ nicht mehr n√ºchtern bei dieser Redenoafd nonazis 	OFFENSE	OFFENSE
NeuesProfilbild 	OTHER	OTHER
Gro√ües Interesse an unserem Webinar zur Politik in Corona - zentrale Themen Backlash und Belastung von Frauen fehlende Unterst√ºtzung von Familien Notwendigkeit Konjunkturprogramme auf allen Ebenen √∂kologisch auszurichten - danke Julia H√∂ller AlexandraGeese 	OTHER	OTHER
Legen Sie doch endlich Ihre geistige Vollverschleierung ab IreneMihalic zur noAfD im Bundestag - ganz gro√ü	OFFENSE	OTHER
NiemaMovassat Na ein Gl√ºck dass Sie das nicht allein entscheiden	OFFENSE	OTHER
Kemmerichs Kinder m√ºssen unter Polizeischutz zur Schule Ehefrau wird bespuckt 	OTHER	OFFENSE
Aufgrund der gro√üen Nachfrage biete ich eine weitere COVID19 Sprechstunde am Freitag den 17 April 2020 von 18-1930 Uhr an Melden Sie sich bei Interesse bitte kurz per E-Mail cananbayramwkbundestagde oder unter 030 61656961 an Friedrichshain Kreuzberg Kotti 	OTHER	OTHER
groehe sagt Gottesdienste unter Hygienema√ünahmen zulassen 	OTHER	OTHER
Das sind 130 Stimmen	OTHER	OTHER
Warum √§u√üert sich die Kanzlerin weder zu Corona noch zur neuen Migrationswelle Haben wir √ºberhaupt ein funktionierendes Staatsoberhaupt IStandWithGreece 	OFFENSE	OTHER
Jeder der in üá©üá™ lebt unsere Gesetze Regeln einh√§lt  unser Werte achtet  lebt muss sich auf 100%igen Schutz des Staates verlassen k√∂nnen Anfeindungen Hass oder Gewalt gegen√ºber Menschen die ihren Glauben friedlich leben d√ºrfen nie toleriert werden 	OTHER	OTHER
Curry ist nicht gelb und braucht kein Fleisch Ein Linsengericht am Mittwoch in der HomeKitchen Folge 18	OTHER	OTHER
Am 14 Januar gab WHO chinesische Propaganda wieder keine √úbertragung coronavirus von Mensch zu Mensch Ich fordere Versagen u Komplizenschaft der WHO aufkl√§ren Wann kommt der Untersuchungsbericht d Bundesregierung Trump ChinaLiedPeopleDied COVID19de Junge_Freiheit 	OTHER	OTHER
Was f√ºr ein widerlicher Mensch der Ziemiak Er behauptetKPF wolle die Verfassung abschaffen Es waren die Kommunisten die in den KZs ermordet wurdendie Konservativendie Hitler erm√§chtigtenUns LINKEN geht es um die Verteidigung des Grundgesetzes linke HHWahl nazisraus	OFFENSE	OFFENSE
kernkompetenz58 c_lindner UllmannMdB Das ist ein anderes Thema	OTHER	OTHER
Yessssss ‚öΩÔ∏è‚ù§Ô∏èüêêMann Was f√ºr ne Sch-Schlussviertelstunde üí© SCPKOE	OTHER	OFFENSE
Wohnen muss bezahlbar sein Deshalb verl√§ngern wir die Mietpreisbremse Wo der Wohnungsmarkt besonders angespannt ist werden Mieterh√∂hungen bei Neu- oder Wiedervermietungen bis 2025 gedeckelt - auf das Niveau der orts√ºblichen Vergleichsmiete plus zehn Prozent spd spdbt 	OTHER	OTHER
vinorosso22 Ich bin auch skeptisch Aber w√§re ja ein Anfang wenn es auch in Deutschland Selbstkritik g√§be	OFFENSE	OTHER
Da schau her Bodo Ramelow 2014 mit AfD-Stimme zum MP gew√§hlt 	OTHER	OTHER
Jenna_Behrends jana_hensel Natascha_Strobl raeuberhose MatthiasMeisner E_Wehling ChristianFuchs_ erik_fluegge	OTHER	OFFENSE
ValerieHoehne Ob in Hanau Halle oder Kassel Die T√§ter t√∂teten weil Rassismus ihr Denken bestimmte Alle Demokraten m√ºssen endlich begreifen Rassismus t√∂tet Fr√ºher oder sp√§ter Danke derspiegel	OFFENSE	OTHER
üêπ K√§ufe m√ºssten ja eigentlich Binnenkonjunktur beleben wie Luzie Aber im Ernst Horten Leute das aus Panik od sind das Gesch√§ftemacher Beim Klopapier h√∂rt Freundschaft auf Vlt sollte man langsam ein paar Dinge f√ºr unsere √Ñrzte und Pfleger beschlagnahmen CoronaVirusDE 	OFFENSE	OTHER
monikalazar anna_cavazzini DB_Bahn √úber Halle	OTHER	OTHER
bruchsal hubwerk01 efeuCus Autonome urbane G√ºterlogistik Hier entsteht ein Leuchtturmprojekt dass ich gerne unterst√ºtze 	OTHER	OTHER
st_klaene CDU Es ist eine Analyse nicht mehr keine Theorie ü§∑‚Äç‚ôÇÔ∏è Wenn er im Angesicht der humanit√§ren Krise vor Kontrollverlust das warnt wei√ü er was er sagt	OTHER	OTHER
Ein paar Gedanken zur aktuellen Debatte aus meinem gerade erschienenen Buch Die Verantwortung der Linken Antikommunismus CDU Thueringen verbrecherei 	OFFENSE	OFFENSE
Vor 5 Jahren wurde Boris Nemzow ermordet Ein Jahrestag der uns an die Aush√∂hlung der russischen Demokratie vor Augen f√ºhrt Wir m√ºssen die Stimme der liberalen Kr√§fte auf der Welt sein die aufgrund autorit√§rer Systeme nicht mehr selbst sprechen k√∂nnen¬†	OTHER	OTHER
MartinGreive jsuedekum Sollte nat√ºrlich doch hei√üen	OTHER	OTHER
liberte_b CDU spdbt Die_Gruenen dieLinke Die Verh√§ltnisse	OTHER	OFFENSE
Wer die Forderungen der noAfD √ºbernimmt wird sie st√§rken nicht schw√§chen Rechtsradikalismus bek√§mpft man nicht indem man sich Migranten  Gefl√ºchtete vorkn√ºpft Rechtsradikalismus bek√§mpft man indem man an der Wurzel des √úbels ansetzt rassistischem radikalem Gedankengut 	OTHER	OTHER
felixsschulz funnynotfunny	OTHER	OTHER
CarloMasala1 fritzfelgentreu MunSecConf üòç	OTHER	OTHER
Statt roter Linien brauchen wir jetzt Dialogbereitschaft und vern√ºnftige L√∂sungen das sind wir den Menschen in den betroffenen St√§dten und Kommunen schuldig	OTHER	OTHER
RaphaelBrinkert KuehniKev larsklingbeil Einfach Sozenliebe	OTHER	OTHER
AlfredMittelbch 9KU2d7vX4x6PEBM Horst Seehofer InnenministerCSU-Politiker den ich mal gesch√§tzthabe ist heute ein Schatten seiner selbst Wenn Selbstverleugnung zumProgramm wirdüßêcoronavirus RefugeesWelcome Rechtsstaat Erdogan Merkel	OFFENSE	OFFENSE
Die Grenzschlie√üungen wegen Corona m√ºssen abgebaut werden Als Sofortma√ünahme sollte auch nicht verheirateten oder eingetragenen Lebenspartnern sowie Grenzpendlern der √úbertritt gestattet werden StZ_NEWS zum Appell der BaW√º MdBs GrueneBundestag 	OTHER	OTHER
Klimawandel oder Wetter Die Frage ist nicht mehr zeitgem√§√ü sorry Wir leben in einer Welt die sich bereits um etwas √ºber 1 Grad erw√§rmt hatLesenswertes Interview mit TerliWetter in der tazSabine Klimakrise 	OTHER	OTHER
felixsschulz Aber warum stelle ich Dich ein damit Du so etwas aussortierst und dann sp√ºlst Du es mir in die Timeline  üòû	OFFENSE	OTHER
Die Rekrutierung von Kindersoldaten ist eines der schlimmsten Verbrechen Der gemeinsamer Einsatz dagegen muss uns allen wichtig seinDanke dass das Deutsche B√ºndnis Kindersoldaten mit tdh_de  vielen anderen am RedHandDay im Bundestag dazu mahnenChildrenNotSoldiers 	OTHER	OTHER
th9tz Hallaschka_HH timstraussspd Nazivergleiche gehen fast immer schief Der Tweet ist wohl eskaboliert	OTHER	OTHER
simplecommonse1 c_lindner Auch Social Distancing ist heute noch angesagt Abstands- und Hygieneregeln gelten weiterhin - TB	OTHER	OTHER
PhlpZnr olafinderbeek Es fehlen zehntausende Erzieher Wir m√ºssen Beruf und Ausbildung attraktiver machen indem wir das Schulgeld abschaffen eine fl√§chendeckende Ausbildungsverg√ºtung einf√ºhren und f√ºr eine bessere Bezahlung nach der Ausbildung sorgen 2/2	OTHER	OTHER
Die FDP Bautzen lehnt pauschale Verbote von Zusammenarbeit ab Politische Hygiene Fehlanzeige Ein ganzer Kreisverband 	OTHER	OTHER
Alle die WirHabenPlatz skandieren sollten doch bitte auch gleich ihre Wohnung r√§umen und Platz machenWirHabenKeinPlatz WirHabenDieSchnauzeVoll von dieser Regierung Merkelmussweg AfD Bundestag	OFFENSE	OTHER
Es gibt viel Neid und Missgunst in der Welt Deshalb sollte man sich sch√ºtzen k√∂nnen 	OTHER	OTHER
Die klare Wahlsiegerin hei√üt fegebanks und GRUENE_Hamburg Ich w√ºrde sagen klarer Regierungsauftrag f√ºr rotgr√ºn mit gest√§rkten gr√ºnen 	OTHER	OTHER
Beim Rennen um CDU-Parteivorsitz scharrt auch Spahn mit den Hufen W√§re sch√∂n wenn er diese Ambitionen und Verantwortung mal als Gesundheit|sminister gegen Pflegenotstand und Krankenhaus|sterben zeigen w√ºrde 	OTHER	OFFENSE
Thema der ersten Diskussionsrunde Wie muss ein Entgeltsystem beschaffen sein so dass die Leistungsf√§higkeit der Werkstattbesch√§ftigten gew√ºrdigt wird aber auch die Wirtschaftlichkeit  der Einrichtung gew√§hrleistet bleibt Wie bekommt man den Einklang hin 	OTHER	OTHER
BachmannRudi handelsblatt CKemfert  null Emissionen bei W√§rme Verkehr Industrie kommt wie man eine extrem auf fossilen Rohstoffen basierende √ñkonomie in wenigen Jahren komplett transformiert das alles sind maximal Nischenthemen und nicht im Mainstream in der klassischen VWL besonders in D 2/2	OTHER	OTHER
aenea_jr Wenn wir nicht da sind kommen die Probleme zu uns nach Hause	OTHER	OTHER
F√ºr Chinesinnen und Chinesen beginnt morgen das Jahr der Ratte üêÄ Frohes Neues G≈çng X«ê FƒÅ C√°i neujahr cny cny2020	OTHER	OTHER
Der Tweet von Ralf_Stegner konterkariert die Tweets von Karl_Lauterbach schneidercar Stegner verurteilt als Alibi vorab um dann zu hetzen  letztlich die Rechtfertigung f√ºr seine Linksextremen Netzwerke zu liefern  Stegner ist ein parlamentarischer Arm des Linksextremismus 	OFFENSE	OFFENSE
hildebentele Ja es gibt auch keine Gr√ºnde warum 4 Kl√§ssler in die Schule gehen sollten Die meisten haben ein Tablet zuhause Dort wo es keines gibt sollten sie ein Leihger√§t durch den Digitalpakt erhalten homeschooling elearning eKlassenzimmer	OTHER	OTHER
Liebe Gr√º√üe vom Landesparteitag der AfD Sachsen in Weinb√∂hla Zum Auftakt hat die Landesgruppe Sachsen ihr traditionelles Banner erhalten und auch unser Fraktionsvorsitzende im Bundestag Dr Alexander Gauland sprach ein Gru√üwort üôÇ 	OTHER	OTHER
Top italienische und deutsche Juristen werten gemeinsam das EZB Urteil aus Seid mit dabei 	OTHER	OTHER
LillyBlaudszun Es ist anscheinend auch so direkt gesagt worden Ich habe mich als B√ºrgermeisterin immer klar von den rechten Idioten abgegrenzt Und das tun die meisten meiner Kolleginnen und Kollegen	OFFENSE	OFFENSE
Kleine M√§dchen mit gro√üen Kulleraugen FehlanzeigeJunge M√§nner mit klarer Botschaft Alle Bullen sind Schweine wurden vom Sozialisten Asselborn in Empfang genommen Der sprach von einem sch√∂nen Tag f√ºr Luxemburg 	OFFENSE	OFFENSE
Wer kann gleichzeitig B√∂cke schie√üen und B√§ren aufbinden Wetten da√ü sich bei Annalenas Luftbr√ºcke bei Ankunft an der dt Grenze 95% als minderj√§hrig herausstellen Sobald sie f√ºr alle Neuank√∂mmlinge Kita/Schulpl√§tze und Wohnraum hat und bezahlt kann sie sich wieder melden 	OFFENSE	OFFENSE
Mit Licht Musik  Kultur die Erinnerung lebendig halten gegen Hass Mord  Nazi-Terror Montag lese ich im Rahmen des Konzerts der gro√üartigen Maria Farantouri aus Texten der Mauthausen-Kantate von Theodorakis/Kanelis 	OTHER	OTHER
k_kehrez Asante	OTHER	OTHER
Ruebenhorst Anka54973800 vendettafsnrev violine1909 Ja dann antworte doch mal	OTHER	OTHER
Mundschutz ist nach 20 Min hilfreich wie feuchtes Taschentuch F√ºr medizinisches Personal verst√§ndlich die in abgegrenzten Zeitraum mit Erkrankten Kontakt haben od f√ºr  Kranke Aber man entkommt kollektiven Problem nicht durch Privatisierung des Mundschutzes coronavirus	OFFENSE	OTHER
An cdu Th√ºringenHier geht‚Äôs um Eure m√∂glichen Stabilit√§tskumpels Genau hinh√∂ren  lesen  dann sehr gut √ºberlegen ob Ihr Ramelow den Th√ºringer Kandidaten dieser potentiellen linken M√∂rdertruppe wirklich an die Macht verhelfen wolltniewieder niewiederSozialismus 	OFFENSE	OTHER
MAStrackZi JoachimSt KonstantinKuhle Wirklich schlimm wir alle ü§∑üèª‚Äç‚ôÇÔ∏èüòâ	OTHER	OTHER
ArgentusX Danke Ihnen TB	OTHER	OTHER
Historiker Winkler - Inflation√§rer Faschismus-Begriff verharmlosend 	OTHER	OFFENSE
demokratienetz wanderwitz Jedenfalls rede ich von mir nicht im Pluralis Majestatis Und welche Art von Parteiarbeit jemand mal f√ºr die CDU gemacht hat der eine AfD-Hetze nach der anderen retweetet m√∂chte ich mir gar nicht vorstellen	OFFENSE	OTHER
ArminLaschet Es hei√üt Mund-NASEN-Schutz vom eigentlichen Thema mal abgesehen COVID19	OTHER	OTHER
Batz geht bald zu Bayern Mega Leistung üí™	OTHER	OTHER
DB_Bahn Warum f√§hrt der Zug von Berlin nicht weiter nach Hamburg	OTHER	OTHER
Was wir abstellen wollen Deshalb werden wir mit diesem irren Furor bek√§mpft 	OFFENSE	OTHER
Die Europ√§ische Union verf√ºgt √ºber Gelder und Ausr√ºstung f√ºr eine staatliche nicht-milit√§rische Seenotrettung im Mittelmeer Die EU-Mittel werden aber nicht angefragt Mein Beitrag zum vors√§tzlichen Ertrinkenlassen im Mittelmeer bei Freiheits_liebe	OTHER	OTHER
Ein H√∂hepunkt zum Ende der IGW2020 die Preisverleihung Unser Dorf hat Zukunft Mit dabei unsere stellv Vorsitzende gitta_connemann und BMin JuliaKloeckner F√ºr uns als cducsubt ist klar die l√§ndliche R√§ume sind die Kraftzentren unseres Landes üí™ 	OTHER	OTHER
In Schweden muss der Wolf den Hund zweifelsfrei bedrohen das haben die Bissspuren vom Wolf an den den Jagdhunden in Brandenburg zweifelsfrei bewiesen und es muss ein Warnschuss abgegeben werden Das ist ebenfalls passiert	OTHER	OTHER
Das Ranking der Firmen beim Klimaschutz wirkt sich zunehmend auf den Wert der Aktie aus Ein weiteres Beispiel daf√ºr dass unsere heutigen Klimaschutzziele zu niedrig sind und ein massiver Ausbau der erneuerbaren Energie auch unsere Arbeitspl√§tze sichert  	OTHER	OTHER
einfuerallemal Bemerkenswerte Schlussfolgerung Man k√∂nnte auch sagen b√∂swillig Wie kommen Sie denn darauf	OFFENSE	OTHER
roth_florian Gruene_Muenchen Soll ich demn√§chst mal so schreiben wer von prominenten Gr√ºnen einen SUV f√§hrt Beispielsweise in M√ºnchen üòÇüòé	OTHER	OFFENSE
Gleich Ansto√ü auf der Bielefelder Alm 	OTHER	OTHER
Genau so ist das mit dem Klimakommunismus  √ñkosozialismus Im Kern totalit√§rJeder Gr√ºnen-W√§hler sollte sich ganz genau √ºberlegen ob er wirklich sein Auto abgeben nie wieder in den Urlaub fliegen  seine Heizung zuhause abschalten willUnd das alles wof√ºrAfD 	OFFENSE	OTHER
lichtmesz 	OTHER	OTHER
Social distancing heute im Treptower Park Meine Prognose In vier Wochen gehen wir mit dem Shutdown wieder auf Los Coronakrise 	OTHER	OTHER
Erinnerung an die Shoa F√ºr das BMVg_Bundeswehr habe ich gestern in yadvashem einen Kranz niedergelegt YadVashemDE 	OTHER	OTHER
HollsteinM Spannende Neuigkeiten Alles Gute f√ºr den weiteren Weg üçÄ	OTHER	OTHER
Alice_Weidel Die AfD ist die einzige Partei in der bundesdeutschen Geschichte die binnen einer Wochen einen AfD- einen FDP- und einen LINKEN-Abgeordnten zum Ministerpr√§sidenten w√§hlen wollte Gaga-Partei	OFFENSE	OTHER
Wie gemaltEttlingen heute bei klarem HimmelAxel_Fischer 	OTHER	OTHER
Die komplette Rede zu den weltweiten Folgen der Corona-Pandemie und deren Auswirkungen auf Menschenrechte und humanit√§re Lage gibt's auf YouTube 	OTHER	OTHER
Leistung muss sich wieder lohnen 90 Kinder unter 14 bekamen steuerfrei Firmen im Wert von 30 Mrd üí∂  2/3 der B√ºrger denen 2018  mehr als 100 Mio Euro √ºbertragen wurden bezahlten darauf gar keine Steuern Erbschaftssteuer 	OTHER	OTHER
Und er hat verdammt rechtIsrael YadVashem Steinmeier 	OTHER	OFFENSE
Die letzten 40 Minuten Jetzt gilt‚Äòs NazisRausHamburgWahl	OTHER	OTHER
RedCaptain030 DB_Bahn So ein typisches M√ºsiko-ischinger-Wortspiel Kann sich jeder seinen eigenen Reim drauf machen Ihrer passt zum Beispiel	OTHER	OTHER
Wir wollen diesen Kindermissbrauch beenden und unterst√ºtzen daher das Kinderhilfswerk der Vereinten Nationen und andere internationale Organisationen die sich gegen die Rekrutierung von Kindersoldaten einsetzen unicefyouth	OTHER	OTHER
LaSuze7 GrueneBundestag GoeringEckardt BriHasselmann Frauenrat juristinnenbund praesidentindjb Jo	OTHER	OTHER
Madenmfer Glaube nicht dass er CumEx meint glaube auch nicht dass er will dass da zu tief gegraben wird ü§∑‚Äç‚ôÇÔ∏è	OTHER	OTHER
B_Strunz LinksfraktionHH Linksfraktion 	OTHER	OFFENSE
Damit stehen bodoramelow und H√∂cke am Mittwoch zur Wahl Ein Demokrat Christ und Gewerkschafter einerseits und ein Faschist andererseits Was machen CDU und FDP in Th√ºringen Bei so einer Frage kann man sich doch nicht enthalten NoNazis NoAfD 	OFFENSE	OTHER
Was f√ºr eine Schande BKin Merkel habe Erdogan beim Bau von t√ºrkischen  Fl√ºchtlingsunterk√ºnften in Syrien  Unterst√ºtzung zugesagt Das ist nichts anderes als Erdogans ethnische S√§uberungen finanziell abzusichern Mein Interview im DLF zur Reise 	OFFENSE	OTHER
Gibt‚Äôs eigentlich auch Umfragef√§lschungen oder Hochrechnungsf√§lschungen - zB im Staatsfunk	OFFENSE	OTHER
DirkLE3 HolgerMannLE BurkhardJung Tr√§um weiter	OTHER	OTHER
In der BILD-Redaktion wird offenbar nur Einwegkleidung getragen ü§î Merkel Davos Outfit Nachhaltigkeit 	OFFENSE	OTHER
Hass und Hetze werfen die Kartellparteien immer wieder der AfDimBundestag vor Lest selbst wer hier die Hetzer sind 	OFFENSE	OFFENSE
Bedenkliches Ergebnis der Pisa-Sonderauswertung Digitalisierung spielt bei Berufsw√ºnschen der Digital Natives kaum eine Rolle M√ºssen viel st√§rker auf digitale Bildung in Schulen setzen um Attraktivit√§t von Berufen zu steigern bei denen die Digitalisierung eine Rolle spielt	OTHER	OTHER
Neodeutscher ClassLibSponge Ja ich meine allgemein Demos etc Familie von Politiker vor allem Kinder geh√∂ren gesch√ºtzt	OTHER	OTHER
Martin Hess sieht in der hohen Anzahl von Hinweisen die sich als nicht sachdienlich erwiesen haben seine Bef√ºrchtungen bewahrheitet da√ü das Telefon hohes Mi√übrauchspotential f√ºr Denunzianten b√∂te die unbescholtene B√ºrger ins Visier der 1/3	OTHER	OTHER
Wenn d CDU jetzt Protektionismus aus Angst vor 'zu viel Europa' ins Programm erhebt ist gem europ√§ische Verteidigung tot Statt Schiffbau sollte man KI Blockchain-Anwendung  Big Data zur nat Strategie erkl√§ren aber das w√§re wohl zuviel Modernit√§t 	OFFENSE	OTHER
TTremonia Es gibt da einen bedeutenden Unterschied Die AfD hatte keine Glaskugel um zu erkennen dass er sp√§ter ein Rechtsterrorist wird Eine Politikerin der Linken hat mit Christian Klar jedoch einen landesweit bekannten Linksterroristen angestellt	OTHER	OTHER
+++ Wahnsinn So schotten sich die Altparteien noch weiter von den B√ºrgern ab - wir von der AfD sind und bleiben dagegen +++nurnochAfD	OFFENSE	OFFENSE
Herzlich Willkommen bei der fdp harald_christ üíõ	OTHER	OTHER
Berichte zu Idlib sind nicht zu ertragen Kinder die auf der Flucht erfrieren und nun bombardieren Assad  Putin gezielt Schulen Kinderg√§rten und Krankenh√§user So komplex es ist Europa kann bei diesen Kriegsverbrechen nicht weiter schweigen 1/2 	OTHER	OTHER
habichthorn Es gibt dort sch√∂nere Orte	OTHER	OTHER
Kriminalit√§t - Trotz Drogenverkaufs an Minderj√§hrige kommt 45-j√§hriger Fl√ºchtling nicht in Haft 	OTHER	OFFENSE
üì∫TV-Tipp f√ºr heute Abend ‚û°Ô∏èHenning Otte unser verteidigungspolitischer Sprecher ist ab 2145 Uhr im ARD-Magazin Panorama zum Thema Rechtsextremismus in der Bundeswehr zu Gast Mehr zur Sendung finden Sie hier üëá 	OTHER	OTHER
PhotosOfMyLife Alleswandeltsich* Jeden Tag ein Foto Eine Woche lang* Keine Menschen keine Erkl√§rungen* Jeden Tsg eine Einladung sich zu beteiligen* Eingeladen von svenseele Meine Einladung sich zu beteiligen geht heute an EnricoTokarEU 	OTHER	OTHER
Heute ist Europ√§ischer Tag des Notrufs und die barrierefreie Notruf-App soll laut Bundesregierung nun endlich kommen Wird auch Zeit - nach sieben Jahren Gespr√§chen Anfragen und Projekten dazu 	OTHER	OTHER
KDHabibi Jaa das w√§re gut Braucht es noch f√ºr jedes Kind ein kostenloses Pad	OTHER	OTHER
EricGrochowski Die Gesamtbelastung aus Abgaben und Steuern war f√ºr die Mittelschicht noch nie so hoch wie heute	OTHER	OFFENSE
Seehofer und Scheuer diskutieren schon zu lange √ºber Drohnenabwehrstrategie ohne Ergebnis Zudem brauchen wir harte Strafen f√ºr unbelehrbare Drohnenpiloten die leichtsinnig  Leben und Sicherheit anderer gef√§hrden der wirtschaftlicher Schaden ist gro√ü   	OFFENSE	OTHER
Sehr gut Ich hoffe Sie verfolgen linksmotivierte Aufkleber mit gleicher H√§rtePolizeiBB 	OTHER	OTHER
Du bist medieninteressiert Zwischen 16 und 20 Jahre Vom 21 bis 28032020 findet der Jugendmedienworkshop 2020  Stadt Land Flucht- Lebens- und Wohnr√§ume heute und in Zukunft in Berlin statt Die Bewerbungsfrist l√§uft noch bis zum 2601 	OTHER	OTHER
spom_heike Da es aber die Option des 3 Wahlganges gibt ist bodoramelow eben NICHT auf die AfD angewiesen Beim Kemmerich h√§tte es keine Mehrheit ohne AfD gegeben	OTHER	OTHER
nepidd hans_rosch kollenbergkai MartinDulig larsklingbeil Gemeinsame Antr√§ge der cdu mit der AfD sind auch in Kommunalparlamenten ein Unding Jede Zusammenarbeit mit einer rechtsradikalen Partei verbietet sich grundhaft	OTHER	OTHER
Irgendwie haben‚Äòs die Altparteien|vertreter neuerdings mit Krankheitsvergleichen bezogen auf Ihre Mitbewerber Nicht sonderlich komisch 	OTHER	OTHER
Bund  L√§nder bleiben weiterhin Fahrplan f√ºr weitere √ñffnung schuldig Lockerungen im Einzelhandel sollten von klaren Kriterien  nicht willk√ºrlich von Ladengr√∂√üe abh√§ngig gemacht werden H√§ndler  Dienstleister brauchen nachvollziehbare Regelungen 	OTHER	OTHER
Kaum hat AKK ihren R√ºckzug angek√ºndigt bringen sich die neoliberalen Rechtsausleger der CDU h√§ndereibend in Stellung Eines unserer gr√∂√üten Probleme ist ein Mangel an sozialem Zusammenhalt und Absicherung Typen wie Merz wirken da wie √ñl im ohnehin lodernden Feuer	OTHER	OTHER
Macht doch mal N√§gel mit K√∂pfen Renteneintrittsalter senken Das ist die richtige Devise  dieLinke Linksfraktion 	OTHER	OFFENSE
Ich verstehe die Aufregung nicht Verbrecher suchen wir seit Jahren mit Gesichtsfahndungsfotos Was ist der Unterschied ob ein Mensch am Bahnhof sitzt und nach den Gesuchten Ausschau h√§lt oder eine Kamera cducsu 	OTHER	OFFENSE
Nach D√ºrren Starkregen √úberschwemmungen zerst√∂ren W√ºstenheuschrecken Weideland und Feldfr√ºchte am Horn von Afrika Werden humanit√§re Unterst√ºtzung noch einmal um 1 Mio EUR aufstocken Insg unterst√ºtzt AA_stabilisiert die Nothilfema√ünahmen der FAO in Ostafrika mit 3 Mio EUR	OTHER	OTHER
Ein fantastischer JogiBitter der das Tor des DHB_Teams sprichw√∂rtlich zugenagelt hatte Der man-of-the-match h√§lt auch unseren tvb1898 Stuttgart erstklassig Tolle Werbung f√ºr Handball EHFEuro2020 HandballEM2020 ü§æ‚Äç‚ôÇÔ∏è 	OTHER	OTHER
Rassismus t√∂tet Fr√ºher oder sp√§ter ‚Å¶cem_oezdemir‚Å© Hanau  	OFFENSE	OFFENSE
fritzfelgentreu spdbt cducsubt EUparliament Das Europarl_DE ist keine Legislative in unserem Staatsrechtlichen Verst√§ndnis Es kann deshalb Entscheidung des Bundestages f√ºr deutsche Einsatzkr√§fte nicht ersetzen Das ginge nur in einem europ√§ischen Bundesstaat und der ist nun wirklich in weiter Ferne	OTHER	OTHER
Direkte Konfrontation ‚úÖBullen angreifen ‚úÖDie linken Gewaltt√§ter aus Antifa und Autonomen haben gehalten was sie versprochen haben Hoffentlich bekommen sie die Konsequenzen unseres Rechtsstaates zu sp√ºrenle2501 linksunten DankePolizei Leipzig 	OTHER	OFFENSE
sarfeld Ich hab es ja schon mal gesagt Maa√üen hat einen an der Klatsche F√§llt einem nix mehr zu ein	OFFENSE	OTHER
FDP raus oder was Und woher kommen auf einmal 56% f√ºr die AfD  Komisch schon gegen 1815 Uhr gestern war es √§hnlich auf dem Portal Da wird doch keiner  oder doch 	OTHER	OTHER
Hier meine Zwischenbemerkung zum Nachlesen und Links zu unseren Antr√§gen zu diesen beiden Punkten- Antrag KurzarbeitergeldPlus einf√ºhren- Allen Wohnungslosen schnell und unb√ºrokratisch helfenKurzarbeitergeld Wohnungslosigkeit Obdachlosigkeit 	OTHER	OTHER
igorpianist nminkmar walli5 üôèsorry aber bei der Verabredung kommst Du schon mal mit ü§ó	OTHER	OTHER
border_knits Vielen Dank Diese klare Haltung hatten aber auch ua KonstantinKuhle johannesvogel JoachimSt Lambsdorff ria_schroeder AnnaVTreuenfels und viele mehr	OTHER	OTHER
SDullien BachmannRudi SGechert sven_kindler GrueneBundestag AchimTruger PeterBofinger tom_krebs_ WielandVolker Oder einfach fragen	OTHER	OFFENSE
Gerichtlich best√§tigtDie Quotenmigrantin der SPD SawsanChebli darf als islamische Sprechpuppe bezeichnet werden	OFFENSE	OFFENSE
Jetzt mal ehrlich liebe FrauenWollt Ihr wirklich nur die Quotenfrau sein Habt Ihr so wenig Selbstbewusstsein Soll nicht die Kompetenz z√§hlen sondern drohende Strafen f√ºr die Firmen Das ist keine Emanzipation das ist schlicht armselig	OFFENSE	OFFENSE
den_tyske bodoramelow Dann w√§re das optisch schlecht aber immer noch egal weil es nichts am Fakt √§ndert dass Bodo die AfD nicht braucht Sie trollt dann halt sinnlos rum u verarscht die Demokratie - und ihre eigenen W√§hler*innen auch	OFFENSE	OTHER
Mit meinem Kollegen Johannes Kahrs besichtige ich heute einige der 4000 Denkm√§ler von Bamberg	OTHER	OTHER
MarcusJogerst Pflegeff HasselerMartina Mach ich ja stimmt ja auch Ihr braucht eine berufsst√§ndische Organisation aller Fachkr√§fte auf Bundesebene	OTHER	OTHER
Neue Woche in Berlin Vielleicht geht alles mal einen Ticken weniger hysterisch Es gibt nichts was man nicht mit Vernunft gut bew√§ltigen k√∂nnte Und nein B√ºcher eines ehemaligen SPD-Vorsitzenden helfen nicht	OTHER	OTHER
Genau wie c_lindner fordere ich auch dass im BMWi_Bund ein Krisenstab eingerichtet wird Denn neben der Bek√§mpfung der gesundheitlichen Krise m√ºssen wir uns auch um die wirtschaftlichen Folgen des CoronavirusOutbreak k√ºmmern peteraltmaier sie sind am Zug 	OTHER	OTHER
Brauchen jetzt 1 Erneuerung des EU-T√ºrkei-Abkommens 2 Debatte √ºber Sicherheitszone/ Flugverbotszone in Idlib wenn notwendig mit Stabilisierungseinsatz 3 Neuen Schub bei Reform des EU-Migrationspakets 4 Mehr Geld f√ºr Migration im neuen EU-Haushalt 	OTHER	OTHER
Heute j√§hrt sich die Unterzeichnung des √âlys√©e-Vertrags Damit wurde die politische rechtliche und symbolische Grundlage f√ºr eine herausragende Kooperation zwischen Deutschland und Frankreich gelegtüá´üá∑ Merci pour votre amiti√©  üá´üá∑ 	OTHER	OTHER
Kinderrechte weltweit sch√ºtzenKein Einsatz von Kindern als Soldat*innen redhandday 	OTHER	OTHER
gloreiche36 KeinBockAufNazi BerlingegenNazi Dankesch√∂n üí™üèΩ‚ô•Ô∏èüëåüèº	OTHER	OFFENSE
ManuelWuest Guck mal bei deren Fraktionsvorsitzender üòâ	OTHER	OTHER
noafd will Erasmus-Programm k√ºrzen es auf ambitionierte Studenten reduzieren Studentinnen Azubis und Sch√ºler*innen rausschmei√üen Antieurop√§er-Fraktion Deutschlands AfD ist krass bildungsfeindlich Bundestag	OFFENSE	OFFENSE
ChewysHomies Ja bei Lanz sa√ü aber der echte Verkehrsminister Scheuer	OTHER	OFFENSE
der_efuchs Bei Ihnen w√§re das deutlich eherangesagt Panlk ist kein guter Ratgeber	OTHER	OTHER
Unw√ºrdiges Schauspiel linker Antideutscher Heute ist ein Tag der stillen Trauer Wer mit Samba den Bombenterror auch noch feiert geh√∂rt gesellschaftlich ge√§chtet Dresden DD1302 	OFFENSE	OFFENSE
In meiner gestrigen Rede im Bundestag zur MP ThueringenWahl habe ich deutlich gezeigt dass der Beschluss der cdu_thueringen nicht mit AfD und Linke zusammenzuarbeiten auch f√ºr Th√ºringen gilt u praktikabel ist Einfach mal ansehen 	OTHER	OTHER
Unglaublich unterirdische Rede von Gauland zur Th√ºringen Wahl im Bundestag noafd noNazis	OFFENSE	OFFENSE
F√ºnf M√§nner bedrohen 22-J√§hrigen mit Messer - Berliner Morgenpost 	OTHER	OTHER
OSchreibt ThomasSigmundHB handelsblatt MartinGreive larsklingbeil Bl√∂dsinn	OFFENSE	OFFENSE
Die dreckigen Folgen der Verbrennung fossiler Stoffe schon heute und bei uns werden immer wieder verdr√§ngt Noch ein Grund f√ºr saubere Energie aus Erneuerbaren Energiewende 	OTHER	OTHER
JPO123456789 Dann ist es Sache der Polizei einzuschreiten Erdogans Schl√§gertrupps haben in Deutschland keine Eingriffsbefugnisse	OFFENSE	OTHER
Das Team ist der Star - keine bl√∂de Idee eigentlich Grad f√ºr eine demokratisch-sozialistische Partei wie ‚Å¶dieLinke‚Å© Mal dr√ºber nachdenken üëç 	OTHER	OTHER
XR_Goettingen xrsaar Mein Zitat zu og √Ñu√üerungen und der Netflix-Serie Wir sind die Welle Kann es bald so etwas wie eine Gr√ºne Armee Fraktion geben nur unter anderem Namen Wie weit darf man gehen f√ºr seine Ideale Kann ein absch√ºssiger Weg von Idealismus zu Gewalt und Terror f√ºhren	OFFENSE	OTHER
redenwirueber GewerkschaftNGG dgb_nds dgb_news sven_kindler an1961weber DGBSAN Anja_Piel Ich freue mich √ºber soviel Solidarit√§t mit den Brauern der Gilde Es gibt keinen Grund f√ºr die Gesch√§ftsf√ºhrung die Gespr√§ch zu verweigern Nur einen sie nehmen eure Rechte nicht ernst K√§mpft weiter	OTHER	OTHER
Wer hart f√ºr sein Geld arbeitet verdient mehr Netto vom Brutto Wenn wir kleine  mittlere Einkommen steuerlich entlasten wollen m√ºssen h√∂chste Einkommen Kapitalertr√§ge und gro√üe Erbschaften endlich h√∂her besteuert werden Das ist Umverteilung und Steuergerechtigkeit	OTHER	OTHER
Altparteienstaatder Wirt ‚ÄömitMesserattackiert beleidigt und bedroht‚ÄòMan habe ihm gesagt da√ü man wiederkommen werde wenn die Veranstaltung stattfinden solle Man wisse wo er wohne und wo er und seine Familie unterwegs seienOSZE 	OFFENSE	OTHER
Der Finanzausschuss hat mit fdp_hessel eine neue Vorsitzende Herzlichen Gl√ºckwunsch liebe Katja Du wirst das gro√üartig machen Vielen Dank liebe Bettina starkwatzinger f√ºr Deine Arbeit als Vorsitzende ich freue mich auf k√ºnftig noch engere Zusammenarbeit als PGFs der fdpbt 	OTHER	OTHER
Gabriel DeutscheBank 	OTHER	OFFENSE
Gegen den Einsatz von Kindern als Soldatinnen und Soldaten z√§hlt heute weltweit jeder rote Handabdruck Lasst unseren Kindern ihre Kindheit Spielplatz und Schule statt Krieg  RedHandDay 	OTHER	OTHER
Elke_Ferner joloulou katarinabarley ManuelaSchwesig UNWomen_Germany klara_geywitz ASF_SPDFrauen FidAReV henrikeVplaten helenadalli PES_Women EvaHoegl Daniela_Behrens Juliane_Seifert üí™ danke	OTHER	OFFENSE
AfD  Curio hetzt wieder  √ÑTZEND 	OFFENSE	OFFENSE
CarloMasala1 barbaragerlach realmanukerber EstherSchapira DSJKlein matthiasfuchs_ _laurakraemer sophianue MarianBracht theresahein_ PolyPepper alexzeyer lind_die sarfeld StefanHennewig Wortpiratin nicolediekmann RAinDiercks KonstantinKuhle Volker_Beck stephanschmidt davidermes Puettmann_Bonn miriam_vollmer HollsteinM Hoellenaufsicht Bitte Ruhe jetzt ich muss schlafen Einfach alle Gin und Tonic mitbringen und es wird eine tolle Runde Und bitte einen Barolo Vielen Dank	OTHER	OFFENSE
Wenn es wirklich irgend wann nur nach Leistung geht haben wir die Gleichberechtigung auf die wir Frauen schon lange warten und verdient haben frauenf√ºrfriedrich 	OTHER	OFFENSE
steiner_harald  sagt einer in dessen Timeline sich AfDler finden Feine Gefolgschaft	OTHER	OFFENSE
aziz_b spdhh Da hast du recht Unter der politischen F√ºhrung einer pragmatischen volksnahen SPD kann das gelingen Der programmatische Ansatz den OlafScholz als B√ºrgermeister mit der spdhh entwickelt hat tr√§gt langfristig und k√∂nnte auch anderswo funktionieren starkerStaat	OTHER	OTHER
Es ist unertr√§glich noAfD Baumann  von Storch spielen die mutma√üliche psychische St√∂rung des T√§ters von Hanau gegen seine eindeutig rassistische Gesinnung ausSie stellen zudem eine gesteigerte Gef√§hrdung von Moscheen infrageKeine Spur von Empathie und Anstand Bundestag	OFFENSE	OTHER
Sie verhindern Straftaten Sie vermitteln Kontakt zu Beratungsstellen bei Drogenkonsum oder Schulden Sie vermitteln Regeln Sie machen Menschen stark die alleine nicht stark sindSozialarbeiter*innen sind der Kitt unserer Gesellschaft die auseinanderf√§llt4/x	OTHER	OTHER
Saarbr√ºcken setzt auf Wasserstoff nicht auf Elektromobilit√§t Klug  	OTHER	OTHER
HappyHatscher DB_Bahn ü§ùüòä	OTHER	OTHER
Die AfD will die Demokratie kaputtmachenFrau Merkel dreht nun endg√ºltig durch  ich hoffe es gibt in ihrem Leben zumindest noch einen Menschen der ihr hilft Bundestag 	OFFENSE	OFFENSE
IngmarStadelman ZDFheute Man m√ºsste die Leistungen kennen die aus den Beitr√§gen zur Sozialversicherung entstehen sonst ist das √Ñpfel mit Birnen verglichen	OTHER	OTHER
lmn80 derspiegel Der Tischwein war gut üôÑ	OTHER	OTHER
Die DDR nicht als Unrechtstaat anerkennen √ºber Erschie√üungen der reichsten 1% faseln und dem Land die Staatsknete nehmen wollen - die Strategiekonferenz hat gezeigt mit welchen Problemen dieLinke noch immer zu k√§mpfen hat 	OFFENSE	OTHER
Unfassbar gegenhalten 	OFFENSE	OTHER
Th√ºringen zeigt den Neofaschisten von NoAfD und H√∂cke die rote Karte DIE LINKE ist im Gegensatz zu CDU  FDP der Garant f√ºr Verteidigung von  Demokratie und sozialer Gerechtigkeit 	OFFENSE	OTHER
Dies sei nachgereicht die tagesschau berichtet am letzten Donnerstag von der Hanau-Debatte Dies sei SPD-Chefin EskenSaskia die unserem Redner R_Hartwig_AfD den R√ºcken kehrt Kein Ordnungsruf Nichts Erb√§rmlichst Antidemokratisch Unw√ºrdig 	OFFENSE	OTHER
Sigmar Gabriel wird Aufsichtsrat bei der Deutschen Bank - nachdem er das sinkende Schiff SPD l√§ngst verlassen hat Ein weiteres Beispiel f√ºr den roten Filz in Deutschland der nur noch der Selbstbereicherung dient 	OFFENSE	OTHER
Hoppla Wohin hatte sich unser wackerer K√§mpfer gegen R√§√§√§chz und neuer Ostbeauftragter Wanderwitz denn da verirrt	OTHER	OFFENSE
Beim Umweltrat verschwimmen die Grenzen zw Wissenschaft  politischer Meinung Musste heute mal ein wenig Kritik am SRU und am neuen Gutachten loswerden Vor allem das willk√ºrlich festgelegte nationale CO2-Budget hat mit wissenschaftlicher Politikberatung nur begrenzt zu tun 	OTHER	OTHER
DD_estikay janapur Da hat man aber mehr von Sonst g√§be es bei mir eine Binge Watching Nacht und ich h√§tte die Serie durch üòÑ	OTHER	OTHER
 baerbelbas  Ich habe im Gesundheitsausschuss nach den Kriterien f√ºr einen Strategiewechsel gefragt und von jensspahn keine Antwort bekommen Die spdbt ist doch noch in der Regierung Sollen wir nochmal gemeinsam fragen 	OTHER	OTHER
BReg will mit dem nationalen Aktionsplan Integration direkt in den Heimatl√§ndern noch mehr Einwanderer anwerben und eine weitere Schleuse f√ºr Masseneinwanderung in unsere Sozialsysteme √∂ffnen Nur  die AfD will das nicht niemals 	OTHER	OTHER
Mit der finanztransaktionssteuer statt Spekulanten Kleinsparer und Rentenvorsorgende treffen und dann bei den kriminellen CumEx Machenschaften der ganz Gro√üen aktiv zur Seite schauen Gelebte Sozialdemokratie im BMF_Bund durch OlafScholz  	OFFENSE	OFFENSE
hubertus_knabe TjaTB	OTHER	OFFENSE
5 Westbalkan unterst√ºtzenKurzfristig EU sollte auch Westbalkan-Staaten Hilfe anbieten falls notwendigLangfristig Auch Migrationskrise f√ºhrt uns vor Augen dass Fortschritte bei Erweiterung in unserem strategischen Interesse sind	OTHER	OTHER
Lieber NowaboFM teilen Sie eigentlich die Auffassung Ihrer SPD-Vorsitzenden-Kollegin dass die Verk√§ufer im Einzelhandel von Berufspolitikern wie EskenSaskia finanziert werden Esken SPD2020 	OTHER	OTHER
Referent aus dem Innenministerium Seehofer bringt die GroKo CDU CSU SPD in Bedr√§ngnis Corona-Ma√ünahmen nur Panikmache bzw zumindest voll √ºberzogen Der zu ehrliche Mitarbeiter ist wohl nun beurlaubt Covid19 Deutschland / Q 	OFFENSE	OTHER
Gabriel DeutscheBank 	OTHER	OFFENSE
TobiasHuch Danke	OTHER	OTHER
Eine gute Nachricht Es wird definitiv keine Olympischen Spiele in Berlin 100 Jahre nach Hitlers Propaganda-Show geben üôè nolympia 	OTHER	OFFENSE
Von der Libyen-Konferenz erwarte ich in erster Linie politische L√∂sungswege und nicht milit√§rische Vorschl√§ge Ohne einen umfassenden Friedensprozess sind m√∂gliche UN-Eins√§tze sinnlos LibyenKonferenz	OTHER	OTHER
AntonGottschalk 1 ist das Unsinn 2Habe ich nichts dagegen hohe Verm√∂gen in Italien zu besteuern 3 Sollen Sie f√ºr niemanden bezahlen In den USA und UK finanzierten Zentralbanken Staatsausgaben in der Krise Die k√∂nnen in eigener W√§hrung nie Pleite gehen 	OTHER	OTHER
Glasklare Kante gegen H√∂cke Gauland und Co heute c_lindner in seiner Rede im Bundestag thuehringen 	OTHER	OFFENSE
LINKEPELLI BoehmeMarco KuengVildeb HolgerMannLE danielakolbe und ClaudiaMaicher	OTHER	OFFENSE
Mehrheiten m√ºssen immer noch in Wahlen gewonnen werden und jede Stimme z√§hlt gleich viel CDUCSU will diese Grunds√§tze anscheinend abschaffen - ziemlich durchschaubar dieses Man√∂ver bei sinkenden Umfrage- und Wahlergebnissen demokratie 	OTHER	OTHER
+++Fast 10000 Menschen haben schon Petition gegen Bonpflicht unterst√ºtzt Das d√ºrfen Bundestag und GroKo nicht ignorieren Alle Betriebe die technische Sicherheitsvorkehrungen treffen geh√∂ren von Bonpflicht befreit+++ MTodtenhausen Mitmachen hier 	OTHER	OTHER
n_roettgen Die_Gruenen Und deshalb muss man sich erpressen lassen Handelsabkommen ohne Klimaschutz Zerst√∂rung des IranDeal Verzicht auf Steuern von Gro√ükonzernen So habe ich mir Europ√§ische Souver√§nit√§t immer vorgestellt 	OTHER	OTHER
NeinEs war lediglich einer von sehr und zu vielen gro√üen Fehlern von Frau Merkel ihren Zu- und Wassertr√§gern und ihren Altparteien	OTHER	OTHER
Herr MdB Brandner hingegen hetzt rund um die Thematik wieder ungebremst mit Schaum vor dem Mund Selbst wenn Herr Chrupalla das alles ernst meint hat er seine Truppe offensichtlich nicht im Griff Siehe auch Parteitag j√ºngst in Weinb√∂hla ua MdB Oehme AfD 	OTHER	OTHER
Duzoe BerlinReporter klee_lina Stimmt Aber das ist ja europ√§isches Recht also nicht allein in deutscher Hand	OTHER	OTHER
Marvin_Weg Kl√§re ich morgen und melde mich	OTHER	OTHER
Manfred Weber Sie sind ein politischer Schmierlapp und Brunbenvergifter allererster G√ºte Franz Josef Strau√ü w√ºrdesich im Grab umdrehen wenn er Sie  die CSU heute sehen w√ºrdeü§ÆEU Europa Br√ºssel  	OFFENSE	OTHER
NowaboFM Ich hatte Herrn Schreiber der hat mir aber auch erkl√§rt wenn man einen Fehler macht kann und muss man ihn korrigieren Allerdings wei√ü ich auch noch dass die Fehler in der Schule meistens rot waren -	OFFENSE	OTHER
AnnLinde HeikoMaas Greetings from Brussels to Berlin Miss you AnnLinde	OTHER	OTHER
st_kaemmerling AndreasBeckerRE sebwatermeier Michael_Huebner Frechheit	OTHER	OTHER
Strategiekonferenz dieLinke in Kassel - Unser Ziel ist ja√ñkosozialismusEnteigungAbschaffung PrivateigentumRadikaler UmbauundReiche erschie√üenMehr muss man √ºber die SED Rechtsnachfolgepartei nicht wissenAfDimBundestagNiewiederSozialismus	OFFENSE	OTHER
evelinnaumann In Bargny in Senegal Die Menschen dort haben wirklich nicht viel aber die Jungs hatten Spa√ü beim Fu√üball	OTHER	OFFENSE
Im Dialog mit den B√ºrgern zum Thema Islam und Menschenrechte in Schmalkalden - Aufkl√§rung √ºber die grundgesetzfeindliche Scharia und die drohende islamische Apartheid tut Not AfD_SThueringen AfD 	OFFENSE	OFFENSE
Das v√∂llige an der Realit√§t vorbei ErikMarquardt die ehemaligen Fl√ºchtlinge aus Syrien Afghanistan oder Afrika die jetzt von Erdogan losgeschickt wurden werden nicht mit dem Tod bedroht 	OFFENSE	OTHER
Erdogans Schl√§ger bedroht in Berlin einen Demonstranten und die daneben stehende Polizei schreitet nicht ein 	OFFENSE	OTHER
Einfach gro√üartig30 Jahre nach dem Fall der Mauer f√§hrt _FriedrichMerz zum Schwatzen in den Osten und ArminLaschet m√∂chte Klassenfahrten nach Rostock und Dresden organisierenMan sp√ºrt richtig wie der Ruck der Erneuerung durch die CDU gehtNur noch AfDAfDimBundestag 	OTHER	OFFENSE
womei68 Ich denke Ihr Tweet reicht sicher aus Ihre politische Unzurechnungsf√§higkeit offenzulegen Aber die ist in Ihrer Partei der Hetzer Menschenfeinde und gewaltbereiten Antidemokraten ohnehin weit verbreitet	OFFENSE	OFFENSE
henningtillmann Nein zB hier 	OTHER	OTHER
2 Schuldenbremse oftmals teurer f√ºr Steuerzahler So w√ºrden Zinslasten bei √úbernahme durch Bund nicht nur f√ºr √ºberschuldete Kommunen sondern auch die Steuerzahler sinken weil der Bund sich g√ºnstiger refinanzieren kann 	OTHER	OTHER
Erdogan's brutale Politik nutzt Menschen als Munition um der europ√§ischen Union die Pistole auf die Brust zu setzen Das ist absolut sch√§big und menschenverachtend Wir m√ºssen das Grundrecht auf Asyl verteidigen Denn WirHabenPlatz	OFFENSE	OTHER
Den h√∂chsten Preis zahlen immer die Schw√§chsten Es ist ein Gebot der Menschlickeit nicht wegzusehen Wenn Kinder allein und schutzlos sind m√ºssen wir gemeinsam mit europ√§ischen Partnern unsere M√∂glichkeiten nutzen um zu helfen Griechenland	OTHER	OTHER
Ich h√§tte mich sehr grunds√§tzlich entschieden keinen Fu√übreit den Faschisten zu lassen Ramelow Thueringen 	OFFENSE	OFFENSE
Die ganze Sch√∂pfung ist die Sch√∂nschrift Gottes und in seiner Schrift gibt es nicht ein sinnloses Zeichen Ernesto Cardenal Ein Revolution√§r ein Geistlicher ein Menschenfischer Dichter Politiker ist gegangen Seine Entschlossenheit  unbedingte Solidarit√§t werden fehlen	OTHER	OTHER
HoffmannForest Merkel tritt wieder an ü§£ Genau mein Humor üôÉ	OFFENSE	OFFENSE
üëáüëáüëá 	OTHER	OTHER
fdpbt ist erste klimaneutrale Fraktion Dazu haben wir das modernste und effektivste Instrument des Klimaschutzes genutzt den Zertifikatehandel	OTHER	OTHER
1/2 Langes Interview mit pnp Wie Niederbayerns Wirtschaft aus dem Klumpenrisiko Automobil rauskommt Wie zukunftstr√§chtiges Hightech ansiedeln was Bildung damit zu tun hat Hatte mir dar√ºber schon l√§nger Gedanken gemacht  f√ºr jeden Bezirk einen detaillierten Masterplan	OTHER	OTHER
Schuldig  Weinstein  Das ist ein Meilenstein - f√ºr alle Frauen MeToo    Danke an jede einzelne mutige Kl√§gerin die das Schweigen gebrochen hat  frauenbildetbanden smashPatriarchy 	OTHER	OFFENSE
Wir haben √ºbrigens 2020 	OTHER	OTHER
1/2 Angesichts der nahezu t√§glichen Angriffe auf Wahlkreisb√ºros AfD-Mitglieder und Mandatstr√§ger ist es geradezu scheinheilig nun einen Krisengipfel einzuberufen um die Demokratie zu sch√ºtzen ohne Vertreter unserer Fraktion teilhaben zu lassen	OFFENSE	OFFENSE
Habe den neuen HDP-Vorsitzenden Mithat Sancar getroffen Wir sprachen √ºber die Lage in der T√ºrkei in Syrien √ºber Europa  unsere M√∂glichkeiten der Zusammenarbeit mithatsancarr m√∂chte erreichen dass die HDP zusammen mit allen demokratischen Kr√§ften in der T√ºrkei mitregiert 	OTHER	OTHER
Dieter_Stein Er ist bekennender Linksextremist	OTHER	OFFENSE
+ PFLEGEBONUS BESCHLOSSEN + Wertsch√§tzung darf sich nicht nur in warmen Worten sondern muss auch bedeuten mehr Euro üí∂ auf dem Bankkonto F√ºr all diejenigen die gerade in der Coronakrise √úbermenschliches‚Ä¶ 	OTHER	OTHER
Die Neutralit√§t|smaske der √ñffentlichRechtlichen √ñR Rundfunk ist endg√ºltig gefallen Sch√∂neborn moderiert schlechte AfD-Prognose in Hamburg ltwhh20  - seine Kollegen jubeln lautstark vor laufender Kamera ARD Staatfunk/GEZ abschaffen / Q 	OFFENSE	OTHER
Wie gehen wir damit umPlattformen zerschlagen Regulieren Oder sollen Demokratinnnen und Demokraten zum Gegenschlag ausholen und ihre Kagnen auf √§hnlichem Fundament bauen da der Zweck die Mittel heiligt Wie auch immer das kann keinen Demokraten kalt lassen	OTHER	OFFENSE
Wenn die Oma auf dem Fahrrad dem  Mercedes Fahrer beim Berg hochfahren zuruft Na wat denn nu Du Affenarsch   Wohlgemerkt weil er h√∂flich ist und erst abbiegen m√∂chte wenn sie sicher an ihm vorbei kommt Das ist Berlin üòâ 	OTHER	OTHER
Soll im Strafgesetzbuch ein Verbot aufgenommen werden EU-Fahne und Hymne sowie ausl√§ndische Fahnen zu verunglimpfen Anh√∂rung dazu im Rechtsausschuss Deutscher Bundestag 	OTHER	OFFENSE
wundertussi FabioDeMasi OlafScholz OliverSchroem B_Strunz CSalewski NDRrecherche MarcusCJung GrueneBundestag Gesagt getan üòâ	OTHER	OFFENSE
T√§glich tausende Liter Desinfektionsmittel produzieren die ABC-Abwehr-Experten der SKB_JSES Die besondere Mixtur hat h√∂here Leistungsdichte als handels√ºbliche Mittel und ist kein Gefahrgut beim Transport  Zur Desinfektion von Fl√§chen R√§umen oder Geb√§uden besonders geeignet 	OTHER	OTHER
Heute war ich im BMVI Dort wurden unter dem Motto SaubereLuft viele F√∂rderbescheide verteilt Auch die FES Frankfurter wird mit √ºber 2500000‚Ç¨ gef√∂rdert Unter anderem f√ºr die Anschaffung neuer Elektrofahrzeuge und f√ºr die Schaffung der dazu ben√∂tigten Infrastruktur 	OTHER	OTHER
So kann man sich das sinkende Bildungsniveau in seiner Regierungszeit auch sch√∂nreden ü§¶üèº‚Äç‚ôÇÔ∏è 	OTHER	OTHER
Es ist irre zur Feier des Kohleausstieg|s ein neues Kohlekraftwerk in Betrieb zu nehmen und auch noch die Rechtsgrundlage zu schaffen f√ºr den Braunkohle Tagebau weiter Menschen zu enteignen und zwangsumzusiedeln Datteln4 Garzweiler 	OFFENSE	OTHER
Einige holen bez√ºglich der m√∂glichen Wahl von bodoramelow zum Ministerpr√§sidenten in Th√ºringen schon wieder die DDR-Vergangenheit von dieLinke heraus Dabei sollten CDU und fdp nicht vergessen dass sie die DDR-Blockparteien vollst√§ndig bei sich aufgenommen haben	OTHER	OTHER
Wolfgang Bosbach in Bestform beim Neujahrsempfang der CDU Esslingen Man darf auch stolz sein auf sein Land ohne in die rechte Ecke gestellt zu werden 	OTHER	OTHER
Buntland auch in meinem Posteingang hier EIN Beispiel - oder ist‚Äôs ein noch unter Strom stehender Kahanej√ºnger der das hamburg|er Wahlergebnis aufarbeitetAAS IDZ KrfgegenRechts 	OFFENSE	OFFENSE
BILD Das ist doch mal eine tolle Meldungalles Gute und viel Gesundheit f√ºr die Zukunft	OTHER	OTHER
DIEZEIT OthmannRonya moerv_vom_doerf erenguevercin primamuslima LamyaKaddor rubenmcloop FerdaAtaman oguz aminajxx KarambaDiaby LadyBitchRay1 Tupoka_O MirnaFunk alicanglobal KanackWelle nhile_de dunjahayali NalanSipar kurtsundgut yasminecmbarek DilmaghaniF mamjahid ismail_kupeli SawsanChebli tochtersatire nbardEff erenguevercin DuezenTekkal alibas76 HudaverdiGungor TahirDella HansSarpei tran_vominhthu kuebra xoxohadnet SerpilMidyatli samelou cihansugur SevimDagdelen	OTHER	OFFENSE
l_u_n_a_tik msur0711 kuebra Ich bilde mir meine Meinung selbst u habe das Gl√ºck u die Ehre K√ºbra pers√∂nlich zu kennen Deshalb K√ºbra ist keine Islamistin	OTHER	OTHER
Die Drohung mit dem Grexit hat zu massiven Verwerfungen in Europa gef√ºhrt Wer L√§nder rausschmei√üen will der st√§rkt nicht Europa üá™üá∫ sondern der spaltet und schw√§cht EuropaMerz 	OTHER	OFFENSE
BorisNannt akk HeikoMaas Die Idee entstammt ja dem Bundestag und damit hat sie eine eigene Qualit√§t sage ich selbstbewusst als einer der Initiatoren	OTHER	OTHER
Man kann auch bis ins hohe Alter an den Weihnachtsmann oder den Klapperstorch glauben Muss man aber nicht 	OFFENSE	OTHER
Erdogans und Europas Krieg gegen die Menschen Es ist furchtbar und menschenverachtend was dort geschieht  wo doch Menschlichkeit und Solidarit√§t angesagt w√§re 	OFFENSE	OFFENSE
Sehr gut Guter Prozess intensive Diskussionen demokratische Entscheidung und ein gutes Ergebnis Bin gespannt welchen Namen diese exzellente Hochschule demn√§chst tr√§gt Ich bin stolz sie in meiner Nachbarschaft und in meinem Wahlkreis zu haben BeuthHS 	OTHER	OTHER
Gestern Abend war der Mob auch im PlenarsaalLiebe Altparteien Ihr k√∂nnt noch so laut br√ºllen Aber wir werden weiter sagen was falsch l√§uft in diesem LandOb euch das nun gef√§llt oder nicht üòé	OTHER	OTHER
Ich wusste schon immer dass victorperli und meine Wenigkeit mit unserer Strafanzeige gegen die schwarze Super Null die letzen glaubw√ºrdigen Vertreter bayerischer Interessen sind ScheuerRuecktritt 	OTHER	OTHER
Mit Schmierereien f√§ngt es an am Ende brennen Stra√üenz√ºge Polizisten werden mit Steinen und Glasflaschen beworfen Was der Linksextremismus anrichtet kann man seit L√§ngerem in Leipzig-Connewitz erleben So weit darf es in SachsenAnhalt nicht kommen	OTHER	OTHER
Dieser ignorante Mann hat definitiv keine Vorstellung was seit Jahren in der Region Idlib f√ºr Gr√§uel von den islamistischen Terroristen begangen wurden H√§tte er sich einmal die M√ºhe gemacht Damaskus Homs Aleppo oder das christliche Maalula zu besuchen w√ºsste er das 	OFFENSE	OFFENSE
Wir haben ein NATO-Mitglied welches einen v√∂lkerrechtswidrigen Krieg in Syrien f√ºhrt und offensiv mit einem Gegen√ºber der NATO kooperiert Dagegen ist das mit den Fl√ºchtlingen ein eher kleines Problem Tuerkei 	OTHER	OTHER
Heute drehen in noAfD ler voll am Rad Sie haben begriffen dass die Demokrat*innen gegen sie zusammenhalten Und  wirsindmehr	OFFENSE	OTHER
FitzWatt fdpbt BMVI Danke f√ºr diese konstruktive Kritik Wieso beschimpfen Sie uns Manchen Sie das im echten Leben auch wenn Sie mit Personen nicht einer Meinung sind TL	OTHER	OTHER
Frau Merkel Sie haben aus Deutschland eine Demokratur gemacht eine Fassadendemokratie und einen defekten Staat Sie sind die gr√∂√üte Bedrohung f√ºr die Demokratie in Deutschland Merkelmussweg ThueringenWahl freieswort de_sputnik TichysEinblick 	OFFENSE	OFFENSE
Wundervoll besonders die Forderung an die NoAfD Legen Sie Ihr geistige Vollverschleierung ab 	OFFENSE	OTHER
Ist √Ñrzt jetzt diskriminierungsfreiVielleicht wissen Chef*innen da Bescheid Diese Sprache lenkt die Aufmerksamkeit weit weg vom Thema  Absichtlich AnneWill	OTHER	OTHER
Die AfD ist der Januskopf des modernen Antisemitismus Auf der parlamentarischen B√ºhne vom Nationalsozialismus und Rechtsterror distanzieren in den eigenen Reihen mit Neonazis und Geschichtsrevisionisten marschieren NoAfD 	OFFENSE	OTHER
Oliver_Krischer Aber das mache ich ja schon die ganze Zeit üòè Aber ich habe da noch eine andere Frage  etwa 1cm lang im Nebengelass entdeckt 	OTHER	OTHER
polit_junkie 	OTHER	OFFENSE
joergprante Na die Schuldenbremse oder ihre Au√üerkraftsetzung sehe ich weniger als ethischen Imperativ sondern als Haushaltsinstrument Mir geht‚Äôs darum dass gangbare Schritte aus Lockdown und Kontaktsperren beschrieben werden	OTHER	OTHER
TobiasHuch fdpbt So ist es üí™üí™ TB	OTHER	OTHER
AnnaBayern Hallaschka_HH maischberger M√∂glicherweise sogar aggressiver als AttilaDerHundi	OTHER	OFFENSE
Happy to have signed up for WoX and to be part of UnidasWe need to strengthen exchange and networking further - especially amongst women across the globewps unwomen feministforeignpolitics 	OTHER	OFFENSE
Wichtig dass AuswaertigesAmt kurzfristig 100 Mio Soforthilfe f√ºr Idlib bereitstellt Falls Putin  Erdogan noch einen Rest Anstand haben setzen sie die K√§mpfe aus um Hilfskonvois eine ungehinderte Zufahrt zu erm√∂glichen 	OFFENSE	OTHER
Berlin zeigt einmal wieder wie gut wir in üá©üá™ vorbereitet sind COVID19 Aber klar wir zeigen Haltung und machen keine Ma√ünahmen die - wie ein fr√ºherer Merkel Innenminister es mal formulierte die Bev√∂lkerung verunsichern w√ºrden TS	OTHER	OTHER
jahmeika Ich liebe AfD-Gegner die vor der b√∂sen ausl√§nderfeindlichen AfD warnen und einer Deutschen dann anraten das Land zu verlassen Immer wieder sch√∂nüòÖüëç	OFFENSE	OFFENSE
Merz Laschet oder R√∂ttgen Das war heute die dominierende Frage beim CDU Pr√§sentÔøº in Lichtenrade - bei erstaunlich guter Stimmung gab es ein ausgeglichenes Bild bei Vorteilen f√ºr das Team Laschet/Spahn Die n√§chsten Wochen werden spannendcduberlin kaiwegner 	OTHER	OTHER
gro√üartig Das hat sowas von gefehlt ‚¨áÔ∏è 	OTHER	OTHER
Ein klares Nein Die Fakten sprechen eindeutig dagegen 	OTHER	OTHER
Was Dorfkinder wollen - schnelles Internet - eine guten regelm√§√üigen √ñPNV mit Bus und Bahn - Schulen wo nicht der Putz von der Decke f√§lltWas Dorfkinder von der Bundesregierung kriegen- die schwarze Null- share pics von der Landwirtschaftsministerin 	OTHER	OTHER
littlewisehen Aber nicht von mir In dem konkreten Fall von zdfheute	OTHER	OTHER
KathrinAnna Viel Erfolg ü§ó	OTHER	OTHER
We should be much more worried about coronavirus putting weaker public health systems under stress where many people are exposed to weaker immune systems due to living conditions and HIV/AIDS 	OTHER	OFFENSE
PaulaPiechotta Ich w√ºsste von keinem Bundesland in dem echtes Ausgangsverbot galt wie zB in Spanien Frankreich und Italien Also Differenzierung w√§re schon angebracht	OTHER	OTHER
HannsSchumacher fdpbt UN Danke Zweckbindungen an sich sind nicht neu aber seit 2014 haben sie bei deutscher humanit√§rer Hilfe rapide zugenommen also nachdem das AuswaertigesAmt FDP-gef√ºhrt war  Siehe dazu auch s_weinlich 	OTHER	OTHER
Die Republik hat eine Bataille verlohren Jetzt ist Ruhe die erste B√ºrgerpflicht Ich fordere die Einwohner Berlins dazu auf Vernunft und Anstand leben  	OTHER	OTHER
PoLILYtik lvzboehmer gehensieweiter Nein Nur f√ºr unsauberes Verhalten muss man sich rechtfertigen F√ºr die anderen Sachen muss man im Zweifel mit Kritik leben k√∂nnen Wer kennt das nicht ü§∑‚Äç‚ôÄÔ∏è	OTHER	OTHER
IreneLienshoeft akk Sie machen es nur noch schlimmer Vielleicht machen Sie mal Twitter-Pause f√ºr heute Mindestens	OTHER	OTHER
 IreneMihalic an die NoAfD im Bundestag Legen Sie ihre geistige Vollverschleierung ab	OFFENSE	OTHER
SPD demonstriert im Landtag ihre Demokratiefeindschaft Sie will Gesetze verbieten die nur dank AfD_FraktionNRW Mehrheit bekommen Dies zeigt SPD-Apparatschiks betrachten AfD-W√§hler nicht als B√ºrger Arrogante Demokratiefeinde schnellstens abw√§hlen	OFFENSE	OTHER
Wer Antidemokraten in den demokratischen Diskurs integrieren will ist auf dem besten Wege die Demokratie abzuschaffenThema der Stunde ist nicht erweiterte Toleranz gegen√ºber AfD-W√§hler*innen sondern Null-Toleranz gegen√ºber der Unkultur des Rassismus von noAfD  Co Gauck 	OFFENSE	OTHER
In Libyen soll also ein UN Waffenembargo weiter gelten dass schon seit 8 Jahren gilt- das sagen die die es seit Jahren ignorieren  Sehr beeindruckendNur Tunesien hatte man vergessen weil die ja auch keine Waffen geliefert hatten- logischGrueneBundestag	OFFENSE	OTHER
Danke 	OTHER	OTHER
netnrd dieLinke JoergSchindler jan_vanaken Gefunden BigBlueButton Hat aber eine Begrenzung auf 60 Minuten pro Konferenz F√§llt also aus	OTHER	OTHER
baerbelbas spdde Gute Fahrt Noch sieht es bei uns ruhig aus	OTHER	OTHER
Und die j√§hrlich hoch zweistellig verschwendeten EU- und Asyl/Sozial-Migranten-Milliarden w√ºrden ausreichen alle Rentner hierzulande auf Beamtenniveau zu hieven 	OFFENSE	OFFENSE
ErikMarquardt was f√ºr eine Schande f√ºr Europa	OFFENSE	OFFENSE
Klimaschutz wird nur global und miteinander erfolgreich sein Nicht gegeneinander Klima-Z√∂lle schaden dem Handel der Wirtschaft Europa und den B√ºrgern Die EU_Commission sollte nicht auch noch gegen offene M√§rkte k√§mpfen 	OTHER	OTHER
politisch_und_k Das Rechte politischen Gegnern gerne den Mund verbieten wollen wissen wir seit 1933 Ich empfehle mal das Grundgesetz zu lesen	OTHER	OTHER
Wo sind die Menschenrechte wenn man sie braucht Was an der EU-Au√üengrenze gerade passiert ist eine Schande f√ºr Europa WirHabenPlatz 	OFFENSE	OFFENSE
Meine pers√∂nliche Erkl√§rung zu dem Abstimmungsverhalten der linksfraktion bei dem Antrag der Union ¬ªAnerkennung der von den Nationalsozialisten als ‚Ä∫Asoziale‚Äπ und ‚Ä∫Berufsverbrecher‚Äπ Verfolgten¬´ im Kulturausschuss und im Bundestag 	OFFENSE	OFFENSE
MEtzold Ok üòä Nur zur Klarstellung Mit dem Reininterpretieren meinte ich Frau Schausten	OTHER	OTHER
CarloMasala1 Ich habe keinen Dissens in der Einsch√§tzung des Landes Und es ist auch nicht vorbildlich bei Unweltschutz Aber das Argument bei den Plastikt√ºten ist es geht nicht Es geht auch ohne ein totalit√§res system	OTHER	OTHER
Gut dass der Senat sich Zeit nimmt um zu abgestimmtem Fahrplan zur Verringerung der Corona-Einschr√§nkungen zu kommenAber was nicht gehtShoppen mit Auflagen wieder erm√∂glichen Demonstrationen aber weiter auch bei Einhaltung aller Hygieneregeln zu verbietenGrundgesetz 	OTHER	OTHER
polenz_r Die CDU bleibt unser politischer Gegner Wir k√§mpfen um jede W√§hlerstimme und f√ºr eine ganz andere Politik Die AfD und alle Faschisten k√∂nnen keine gleichberechtigten Gegner im demokratischen Streit sein weil sie Feinde der Demokratie sind - und damit unser aller Feinde	OFFENSE	OFFENSE
Die ungekr√∂nte spdbt-K√∂nigin der Fehleinsch√§tzungen Aydan oezoguz hat ihren Titel bravour√∂s verteidigtAfDimBundestag AfD 	OTHER	OTHER
Buerger_Berlin kbv4u Guter Tipp	OTHER	OTHER
stniew halldaudeimaul sarfeld Wieso sollte er nicht Er hat ihn entlassen	OTHER	OTHER
RantanplanSVW mginpl Ok sann begr√ºnden Sie doch bitte was an der Bezeichnung von Nuhr als rechts faschistisch ist Er kann ja seine Comedy machen ich kann sie trotzdem f√ºr schlecht und rechts halten meinungsfreiheit	OFFENSE	OFFENSE
Ein Blick ins Gesetz erspart viel Geschw√§tz Einfach mal in Berliner Gesetzen nachlesen wer √ºber  den Mietendeckel entscheidet Genau Nicht der Baustadtrat von Friedrichshain Kreuzberg Danke bizimkiez gloreiche36 u67bleibt krossener36 f√ºr Solidarit√§t ‚úäüèºüíö f_schmidt_BB 	OTHER	OTHER
AnnaBayern von ihm wohl	OTHER	OTHER
Ein Grund Feminismus zu feiern 30 Jahre gibt es das FRIEDA Frauenzentrum in friedrichshain Berlin 	OTHER	OFFENSE
SusanIrani2 Sie sollten Menschen an dem beurteilen was sie machen und noch nach dem was deren Gegner √ºber sie sagen	OTHER	OTHER
Ministerin Karliczekwann nehmen Sie Stellung zum Skandal um MobbingVertreibung‚Äô des weltber√ºhmten Hirnforschers  Nikos 	OTHER	OTHER
Das Wort Gesindel - wer oder was auch immer damit gemeint ist - sagt sehr viel Negatives √ºber denjenigen aus der es sagt So redet nur jemand der Menschen abwerten will	OTHER	OFFENSE
NetzfundRamelow Linke Gauland AfDThueringenwahl CDU MerkelHHWahl 	OTHER	OFFENSE
Haifonix_ Spaltung zu verurteilen ist kein Spalten	OTHER	OTHER
SusanneSpaun D_Herrmann sarfeld Ersteres hat er jedenfalls nicht	OTHER	OTHER
vulcanbiker ZDFheute Der Spitzensteuersatz wirkt nur auf die Spitze Auf das gesamte Einkommen bezahlt man mit 57T‚Ç¨ zu versteuerndem  Einkommen 19% Steuern	OTHER	OTHER
svenlehmann KonstantinKuhle Na endlich aber es hatte sie auch niemand dran gehindert Etwas kurios kommt es mur trotzdem vor Ist die Motivation nun  es nicht uns zu √ºberlassen als Thema oder in der Sache weil Rechtsextremismus Menschen u d Demokratie zerst√∂rt ü§î	OTHER	OTHER
Gera Eine Gruppe aus zwei unbekannten M√§nner|nüßê	OTHER	OTHER
Kaffeoxitant Schon klar aber Skinhead geht √ºberhaupt nicht Die Spirale von Drohungen Hass und Gewalt geht immer weiter da hilft dieser Spa√ü sicher nicht	OTHER	OTHER
realAlexBlank fdp Sorry aber q e d Das fordere ich gerade nicht geradezu im Gegenteil Ohne die USA geht es nicht	OTHER	OTHER
katjadoerner BMFSFJ BMBF_Bund Ist das der Versuch vom BMFSFJ den anderen Gru√ü vergessen zu machen	OTHER	OTHER
Na ihr Hetzer von  spdde Die_Gruenen Eure Freude √ºber das Verdr√§ngen der afd als einziger demokratischer Opposition kam zu fr√ºh üòéIhr k√∂nnt keine Extremisten-Herrschaft ohne Opposition in Hamburg errichten ABaerbock larsklingbeil HamburgWahl	OFFENSE	OTHER
Steuergeldverschwendung	OFFENSE	OFFENSE
Dieses Ma√ü an Demokratie sollte endlich auch im Bundestag Einzug halten Der Bundestagvizepr√§sident wird der AfDimBundestag weiterhin verweigert Eine Schande 	OFFENSE	OTHER
Die √ñRR machen heute ihrem Haltungsjournalismus alle Ehren Erst der Applaus bei dem Balken f√ºr die AfD und dann das Das ist kein neutraler Journalismus Leider wenig √ºberraschend TS HHWahl 	OFFENSE	OFFENSE
ClaudiaPotsdam Es ist einfach nur unglaubw√ºrdig Ein Wolf im Schafspelz TB	OFFENSE	OFFENSE
jana_hensel wanderwitz Ne ostdeutsche Frau im BMI das w√§re doch mal was -	OTHER	OFFENSE
Buntland in der Mitte	OTHER	OFFENSE
Buongiorno aus Franken	OTHER	OTHER
Nicht das irgendjemand glaubtdas ich die üá©üá™ Bundesregierung auf die richtigeüòé F√§hrte bringen willCoronaVirusDE coronavirus COVID2019 CO2 Klimakrise klimaathysterie Merkel AfD 	OTHER	OTHER
Da spendet der Baul√∂we Christian Krawinkel 100000 ‚Ç¨ an die radikale H√∂cke-AfD nachdem er sich mit wegen politischer Widerst√§nde ungenutzten Fl√ºchtlingsunterk√ºnften aus Berlins Landeskasse die Taschen gef√ºllt hat Kann man sich nicht ausdenken noAfD 	OFFENSE	OTHER
Das ist wieder Werbekagne der Gr√ºnen Kinder sind nicht alleine sondern mit Mutter oder Familie Unbegleitet sind Jugendliche Seehofer muss die griechischen Beh√∂rden unzterst√ºtzten die Asylverfahren schnell abzuarbeiten 	OFFENSE	OTHER
Heute sind wir in Offenburg beim Vernetzungstreffen gegen den AfD Bundesparteitag in der Alevitischen Gemeinde Offenburg NeinzumAfDBundesparteitag 	OTHER	OTHER
AKS03350356 DieterFrump fdpbt P TB	OTHER	OTHER
Superreiche besitzen so viel Verm√∂gen wie 46 Milliarden Menschen weltweit Oxfam hat eine Studie ver√∂ffentlicht die deutlich zeigt wie ungerecht das aktuelle Wirtschaftssystem ist Kein Mensch braucht soviel Verm√∂gen Zeit zum Umverteilen an die Vielen Oxfam 	OTHER	OTHER
Also Robert Habeck mit seiner klaren Haltung ist mir da  deutlich lieber als alle Trumpversteher von CDU und Junge Union 	OFFENSE	OFFENSE
Was machen wir mit geistigen Brandstiftern f√ºr Terrorakte wie in Hanau Helfen Parteiverbote Schon Sch√ºler wissen dass NPD und AfD verboten geh√∂ren sagt FabianGrischkat Ich halte gegen Wir leben in einem Rechtsstaat Das Bundesverfassungsgericht hat sehr anspruchsvolle	OFFENSE	OTHER
UliGroetsch NowaboFM BayernSPD BayernSPD_LG spdde sehr richtigund Schausteller brauchen das auch	OTHER	OTHER
H√∂chste Parteispende seit 2016 Berliner Unternehmer Krawinkel gibt 100000 Euro an H√∂ckes AfD - Berlin - Tagesspiegel Mobil Sehr gut 	OTHER	OTHER
bstrasser BBK_Bund Dann kann die FDP ja unserem Antrag zustimmen das BBK mit einer Zentralstellenfunktion auszustatten	OTHER	OTHER
Schei√ü Deutscher Amateur-Boxer Abud Abu auf der Stra√üe verpr√ºgelt Unfassbar T√§ter sofort abschieben 	OFFENSE	OFFENSE
Rassismus Antisemitismus Chauvinismus Demokratiefeindlichkeit - niemand sollte die fckafd mehr verharmlosen ü§∑‚Äç‚ôÇÔ∏è Sie wird gew√§hlt weil ihre Positionen anschlussf√§hig sind an das Weltbild ihrer W√§hler*innen Das hat auch die HHWahl nach Hanau gezeigt	OFFENSE	OTHER
nazisraus	OTHER	OFFENSE
7777 Follower ü•≥ Danke f√ºrs Folgen und f√ºr die Diskussionen	OTHER	OTHER
Tolle erste Prognose - der Norden ist Gr√ºn üíöü•≥ und Naziiiisss raus üëèüèΩ 	OTHER	OFFENSE
Martin_Debes n_roettgen Danke f√ºr diese typisch sachlich-distanzierte Aussage eines ausgewogen berichtenden Qualit√§tsjournalistenEinen Moment war ich jetzt in der Versuchung N Roettgen sympathisch zu finden Auch dieses innige Lob durch einen Ramelow-Fanboy reicht leider nichtTh√ºringen	OTHER	OTHER
Freue mich morgen nicht hinzugehen und trotzdem dabei zu seinKeinerKommt 	OTHER	OTHER
Serviceopposition Aufstiegsversprechen FDP 	OTHER	OTHER
StefanGelbhaar SabineRennefanz berlinerzeitung Ein Demographieministerium w√§re entweder f√ºr alles oder f√ºr Nichts federf√ºhrend Entscheidend ist aber das gemeinsame Agieren bei gleichen Zielen ü§ó	OTHER	OTHER
perzelmeier cducsubt Wo ist denn Ihrer Meinung nach der Mittelpunkt der Demokratie	OTHER	OTHER
Ich finde den Versuch der SPD die FDP und die CDU aus dem Konsens demokratischer Parteien hinaus zu definieren menschlich problematisch parlamentarisch unkollegial und politisch dumm	OTHER	OTHER
Evaohlerth1 SlamCare SawsanChebli Bei mir geht es heute eigentlich fast nur um Covid19 und PflegeSt√§rken	OTHER	OTHER
Die FDP hat die Demokratie schwer gesch√§digt und mit dem Faschisten H√∂cke Gesch√§fte gemacht Jamaika ablehnen und dann so eine Nummersprachlos 	OFFENSE	OFFENSE
alterVerwalter6 ANiebler Wir brauchen beides	OTHER	OTHER
KlaasTamme spdbt peteraltmaier Ein Versto√ü gegen die Bonpflicht ist nicht bu√ügeldbewehrt Fragen Sie das BMF_Bund Ein Bu√ügeld droht nur bei Verwendung eines nicht zertifizierten AufzeichnungssystemsWo gibt es Bagatellgrenzen Eine solche l√§sst genau solche Vorg√§nge unber√ºcksichtigt wo h√§ufig betrogen wird	OTHER	OFFENSE
3 Interessanter ist das von Harvard Uni entwickelte kombinatorische Pooling Wieder zB 10 Proben je Pool Aber jede Probe auf zB 3 Pools aufgeteilt Der Trick der zweite Test entf√§llt fast immer da die Kombinationen die positive Probe identifizieren	OTHER	OTHER
TimDemisch Aha Ich w√ºrde das bestreiten klingt mehr nach Propaganda ich erlebe das eher aus dem Establishment der Partei von Clinton und anderen Aber gibt es denn f√ºr Ihre These einen Beleg	OTHER	OFFENSE
V√∂lliger Realit√§tsverlust bei c_lindner Es waren die Gesinnungsgenossen eines Ramelow die KemmerichThL und seine Familie bedroht habenEs sind dessen Gesinnungsgenossen die Massenmord und Arbeitslager f√ºr Reiche diskutieren Diesen Leuten biedert sich Lindner an PFUI 	OFFENSE	OFFENSE
Sehr zutreffender Satz von Hubert Burda Burda Die gr√∂√üten Fehler in Verlagen passieren wenn Verleger keine Ahnung von Technik und Journalisten keine Ahnung vom Verlag haben 	OTHER	OFFENSE
Altparteienstaat2020 schwuppsderJobweg	OFFENSE	OFFENSE
In der neuesten Podcast-Folge von abendblatt-Chefredakteur Lars Haider haben mein Kollege Philipp_Amthor und ich darauf einige Antworten gegebenViel Spa√ü beim Lesen und H√∂ren [2/2]	OTHER	OTHER
Moin Hamburg Schlusspurt Noch gut 75 Minuten die Nazis aus dem Parlament rauszuw√§hlen Mein pers√∂nlicher Tipp GRUENE_Hamburg und TeamFegebank ankreuzen  HamburgWahl	OTHER	OFFENSE
Schon mal davon geh√∂rt dass Eltern ihr Sorgerecht verlieren sollen weil ihre Kinder an Nazidemos teilnehmen Nein Na dann noch Fragen Ginge es um das Kindeswohl h√§tte man die Kids diesem Verfahren nie aussetzen d√ºrfen Pfui Staatsanwaltschaft  	OFFENSE	OFFENSE
NABU SH √ºberlie√ü Konikpferde sich selbst Folgen unkontrollierte Vermehrung Verwahrlosung Todesf√§lle Geld allein reicht nicht um Tiere artgerecht zu halten Es braucht auch Wissen Sachverstand und Erfahrung - die z B Landwirte haben	OTHER	OTHER
trevou_bjs MoritzMichelson Das stimmt nicht Wir waren in diesem Punkt niemals stumm Und haben immer jeglichen Extremismus - auch von links - verurteilt TB	OTHER	OFFENSE
Mit diesem Nachwuchs ist wenigstens sicher dass die CDU in 10-20 Jahren ein Kleinstpartei ist Bei der Wahl zwischen Ramelow und H√∂cke aus dem Plenarsaal fl√ºchten - irre 	OFFENSE	OTHER
2/2 Und wenn sie auch eine Minderheit in der CDU darstellt so braucht sie klare √Ñchtung und einen Beschluss zur Unvereinbarkeit mit den Werten der Union Schade dass auch die CDU_BW in Vergangenheit eher zur Aufwertung beigetragen hat	OTHER	OTHER
Der Versuch den Verbrennungsmotor durch ein unausgereiftes teures und in der Klimabilanz desastr√∂ses Produkt  E-Auto zu verdr√§ngen wird Deutschland in den Abgrund treiben Deutschland unter der Regierung Merkel macht sich auf den Weg in die wirtschaftliche Bedeutungslosigkeit 	OFFENSE	OTHER
Genauso lieber ‚Å¶HasnainKazim‚Å© ich mag diese Opferrolle nicht in die man von diesen Leuten gezwungen wird Die Bedrohung und derHass dominieren den Alltagder eigentlich selbstgew√§hlter journalistischer ArbeitFamilie u√§ vorbehalten sein sollte 	OTHER	OTHER
BotheNico CDU ArminLaschet Die Partei insgesamt sei verantwortlich f√ºr die klar zu missbilligende Position Einzelner	OFFENSE	OTHER
JulianAssange war seit gestern in 5 verschiedenen Zellen inhaftiert 11 mal wurden ihm Handschellen angelegt 2mal gab es nackte Leibesvisitationen und seine ihm pers√∂nlich zustehenden privaten Unterlagen wurden bei Verlassen u Betreten des Gef√§ngnis konfisziert FreeAssange	OTHER	OTHER
KanguruKlein Das machen wir und das wird auch noch lange andauern TB	OTHER	OTHER
Team_Luftwaffe Gro√üartig herzlichen Gl√ºckwunsch	OTHER	OTHER
AlexNeuber berlinerzeitung Nicht in Berlin	OTHER	OTHER
BorgardtDennis Alles richtig was da steht 	OTHER	OTHER
SteinekeCDU rbrinkhaus cducsubt Eine wirklich interessante Aufgabe mit Themen und Probleme die viele Menschen in Deutschland betreffen Gut dass du das machst Viel Erfolg und Spa√ü an der neuen Arbeit	OTHER	OTHER
Aktuelle Stunde zur Th√ºringen Wahl im Bundestag schneidercar stellt klar Die Sozialdemokraten sind das Bollwerk des Antifaschismusgegenhalten WirSindMehr spdbt spdde 	OTHER	OTHER
georgrestle Zu fr√ºh gefreut Sie von GEZ Zwangsgeb√ºhren finanzierter M√∂chtegern Journalist	OFFENSE	OFFENSE
Intensive Debatte zur Windenergie im Wirtschaftsausschuss Windenergie politisch einschr√§nken und dennoch an den Zielen f√ºr Erneuerbare Energien festhalten zeigt die Inkonsequenz der cducsubt H√∂ren Sie auf St√§dte und l√§ndlichen Raum gegeneinander auszuspielen Energiewende	OTHER	OTHER
Danke Thank you Merci Und eine Bitte Steht auf gegen Nationalismus und Populismus Seid laut gegen alte und neue Nazis Gebt Rassismus Hass und Demokratieverachtung keinen Raum K√§mpft f√ºr eine solidarische demokratische und weltoffene Gesellschaft 	OTHER	OTHER
Meine Rede zum Coronasteuergesetz  afd  	OTHER	OTHER
lederwalze MPKretschmer Aus der ganzen Welt wurden 2011 Terroristen nach Syrien gekarrtum dort Interessen Saudi ArabiensKatars der T√ºrkei und einiger westlicher Staaten durchzusetzenHeute sitzt diese Brut in Idlib und versucht von dort nach Europa zugelangenAlQaeda Migration Greece	OFFENSE	OFFENSE
Die GroKo in Niedersachsen streicht ab Oktober 2020 die Mittel f√ºr b√ºrgerschaftliches Engagement in der Fl√ºchtlingshilfe und setzt die gro√üen Erfolge der vergangenen Jahre damit aufs Spiel Ein v√∂llig falsches Signal Anne_Kura 	OTHER	OTHER
Zitat Die Bundesregierung erkl√§rte sie gehe davon aus und erwarte dass das EU-T√ºrkei-Abkommen eingehalten wirdWie naiv wie hilflos kann man eigentlich noch sein Anstatt endlich selbst zu handeln Asylkrise Erdogan AfD 	OFFENSE	OTHER
FrozenPatrick Der Antidemokrat bedient sich des demokratischen Rechtsstaats Keine Pointe	OTHER	OFFENSE
Bei den s√ºdhessischen Jusos auf ihrem Seminar in Wiesbaden Wir haben 2 interessante Stunden √ºber das neue Sozialstaatskonzept der SPD diskutiert Recht auf Arbeit Sozialstaat als Partner der das Leben 	OTHER	OTHER
JiyanGcer1 Markus_Soeder ArminLaschet Thema Unterversorgung Schutzg√ºtern Masken etc ist auch ein eklatantes Versagen	OTHER	OTHER
Das Finanzministerium widerspricht auf meine Anfrage hin Staatsanw√§lten aus NRW die Verj√§hrung von CumEx Abzocke bef√ºrchten Ehrlich gesagt ist mein Vertrauen in die Staatsanw√§lte gr√∂√üer  MarcusCJung 	OTHER	OTHER
FrankWalterFischfiletüôÑ ob seine Werbung f√ºr primitive Krawallcombos wie FSF KIZ  Co auch versehentlich warü§î 	OFFENSE	OFFENSE
Die Passage zum Impfpass wurde auch gestrichen	OTHER	OTHER
Lesenswerter Beitrag von Bill Gates im New England Journal of Medicine zur Coronapandemie Covid-19 ist eine Warnung f√ºr die Herausforderungen durch neue Viren im Zeitalter der Globalisierung ein Preis den wir zahlen f√ºr Globalisierung zahlen  	OTHER	OTHER
beimwort FJ_Murau Und er ist stolz kein Lobbyist geworden zu sein ü§∑üèº‚Äç‚ôÇÔ∏è	OTHER	OTHER
F√ºr mich als Politiker ein mich dynamisierender EventSprach mit Teilnehmern der EvAkademie zu und der Kath Akademie in Berlin √ºber Dilemmata der F√ºhrung in der √Ñra der Digitalisierung Wie sch√∂n im intellektuellen Disput mit Menschen au√üerhalb politischer Blase zu sein 	OTHER	OFFENSE
Auch ich arbeite digital weiter ‚Äì hier spreche ich mich mit meinem Team ‚ù§Ô∏è ab 	OTHER	OTHER
Concer17 Soviel zum Thema Stimmung anheizen üëáüèª 	OTHER	OTHER
Arnd_Diringer RAStadler WELTAMSONNTAG welt jetzt bin ich noch neugieriger	OTHER	OTHER
BM Seehofer Wir brauchen einen starken Staat wenn es um den Schutz unserer freiheitlichen Grundordnung geht Wir m√ºssen jeden Tag f√ºr diesen starken Staat arbeiten f√ºr die mutigen Demokraten Wir m√ºssen jene sch√ºtzen die uns sch√ºtzen  BMI_Bund 	OTHER	OTHER
Oh Kollege Lindner c_lindner lebt nochNach 15 Tagen heftigem Nachdenken traut er sich fast so etwas wie Kritik am infantil-arroganten Habeck zu √ºben Mutig mutigMu√üte erst gekl√§rt werden ob die FDPSchleimspur zu den Gr√ºnen nicht taktisch besser w√§reDavos 	OFFENSE	OTHER
Erstens hat Ramelow das so nicht gesagt Und zweitens m√ºssen Sie als Nazi sich zu undemokratischen Haltungen √§ussern Diese leben Sie vor 	OFFENSE	OFFENSE
HSchaeferIW Stimmt es gibt sehr viele Million√§rss√∂hne die erwerbslos sind und unbedingt in HartzIV leben wollen Richtig gutes lebensnahes Beispiel	OFFENSE	OFFENSE
Staatsknete abgreifen Parlamente SCHW√ÑCHEN aus der Strategie der Linken 	OFFENSE	OFFENSE
KenzoVandagg dieLinke DieLinke_HH LinksfraktionHH Neid Im Unterschied zu Ihren Freunden von den Liberalen fordert er h√∂here Steuern f√ºr sich selbst und hat ein Leben lang f√ºr die hart arbeitende Bev√∂lkerung gek√§mpft	OTHER	OTHER
Anfrage von mir zeigt Bundesregierung subventioniert mit √ºber 7 Milliarden j√§hrlich den schmutzigen Diesel 7 Milliarden Steuergeld f√ºr Klimazerst√∂rung und dreckige Luft Was k√∂nnte man damit alles Gutes machen√ñPNV Bahn Fahrrad Emobility 	OFFENSE	OTHER
Moin Diese Woche bleibe ich in Schleswig-Holstein Es stehen verschiedene Termine hier an Z B Gespr√§che mit Sch√ºlerinnen u Sch√ºlern Besuch des Frauen- u M√§dchentreffs in Eckernf√∂rde Jahresempf√§nge sowie SPD-Versammlungen u eine Team-Klausur Allen eine gute Woche	OTHER	OTHER
LibWoman2 CDU SawsanChebli Hass ist keine Meinung	OFFENSE	OFFENSE
Gute Strategiekonferenz von dieLinke ‚ò∫Ô∏è Zum Schluss tolles Podium f√ºr migrantische  feministische Politikf√ºr Verbindung unserer K√§mpfe b_riexinger f√ºhrt Debatten klug zusammenWir haben eine gesamtdeutsche Linke auf die Beine gestellt Wir haben eine Zukunft zu gewinnen 	OTHER	OFFENSE
üëç 	OTHER	OTHER
NikolasKaranik2 und seine Familie wurden Opfer eines ausl√§nderfeindlichen Angriffs In den letzten Jahren wurde bei Gewalt von rechts schon jede Menge versemmelt Daraus sollten die Ermittlungsbeh√∂rden gelernt haben buntstattbraun SPD Solidarit√§t 	OFFENSE	OTHER
queer_de Widerlich Deswegen brauchen wir in unserer Verfassung in Art 3 Abs 3 ein klares und deutliches Signal dass auch die sexuelle Identit√§t grundrechtlichen Schutz genie√üt Wir wollen eine offene und tolerante Gesellschaft ohne Diskriminierung Hass  Homophobie üè≥Ô∏è‚Äçüåà	OFFENSE	OTHER
F√ºr dieLinke ist klar Nie wieder Sozialismus ohne demokratischen Rechtsstaat Trotzdem reden PaulZiemiak und die CDU lieber √ºber unsere Vergangenheit als √ºber die eigene Warum eigentlich 	OTHER	OTHER
Was mich sehr besorgt dass ein gro√üer Riss bei den demokratischen Vorwahlen zwischen Progressiven und Establishment zu sehen ist personalisiert durch das sich jetzt abzeichnende Duell Sanders vs Biden Von dieser Spaltung profitiert einer und das ist Trump	OTHER	OTHER
Keine Partei wird √∂fter angegriffen als die AfDüò°Auch wir in M√ºnchen werden im Wahlkf zur Kommunalwahl massiv behindert und ausgegrenzt Plakate werden zerst√∂rt Beleidigungen an Infost√§nden sind an der TagesordnungWir bleiben starküí™	OTHER	OFFENSE
SPD_LSA Wundersch√∂n -	OTHER	OTHER
Irrsinn dein Name ist R√∂ttgenErdogan unterst√ºtzt ISISgreift Syrien an eindeutig gegen das V√∂lkerrecht bricht trotz Mrd‚Ç¨ von dt Steuergeldern den Fl√ºchtlingspakt und schickt illegale Migranten in Richtung EU Alles nur ein Hilferuf Irre IStandWithGreece 	OFFENSE	OFFENSE
Ganz einfach ChristophPelli1 weil diese Anlagen ohne weiteres eben keinen Beitrag leisten Volatilit√§t contra Versorgungssicherheit 	OTHER	OTHER
Wir werden mit Kritik konfrontiert und wir nehmen diese Kritik auch an Wenn aber j√ºdische Kommunalpolitiker der FDP in FFM als Nazis beschimpft werden wenn Kinder von FDP-Mitgliedern angegriffen werden und wenn Gesch√§ftsstellen beschmiert werden - dann geht das zu weit TL 	OFFENSE	OFFENSE
Ein Wahlabend wie er sch√∂ner kaum sein k√∂nnte Triumphales Ergebnis f√ºr fegebanks und die progressiven Kr√§fte in Hamburg Und die Zivilgesellschaft sagt noAfD Hammer Hamburg wir sind stolz auf euch HH2020	OTHER	OTHER
Horst einfach mal nachdenken ist doch nicht so schwer die Frage wie man gefl√ºchteten Kindern in Griechenland helfen kann Essen Unterkunft Schule sicherer Aufenthaltsort Zusammenf√ºhrung mit Familie Gibt viele dt St√§dte die dabei helfen w√ºrden 	OFFENSE	OTHER
Dass die Sachsen CDU und MPKretschmer mit Kommunisten und Linksextremen gegen konservative Patrioten demonstriert ist in der Tat befremdlichArmdeslinksterrorismusniewiederCDU NiewiederSozialismus 	OFFENSE	OFFENSE
Meine Worte schon lange Repr√§sentative Tests in klaren zeitlichen Abst√§nden Corvid19DE Die Risikogruppen m√ºssen identifiziert informiert und gesch√ºtzt werden Auch in den Schulen Landkreisweite Risikoklassen digital unterrichtet von den √ú60 Lehrern fdpbt 	OTHER	OTHER
Zwei Bitten habe ich1 Geduld Gelassenheit und Disziplin sonst waren die letzten Wochen f√ºr die Katz2 Geht zu Eurem Einzelh√§ndler um die Ecke Er braucht uns jetzt 	OTHER	OTHER
Die AfD spielt mal wieder mit verteilten Rollen Gestern galt noch die chauvinistische Losung nach Rentenzuschl√§gen nur f√ºr Deutsche  heute will Chrupalla von alledem nichts mehr wissen Rentenpolitk  die AfD - das passt √ºberhaupt nicht spdbt spdde 	OFFENSE	OTHER
st_klaene CDU Ich sag's mal so 	OTHER	OTHER
MdB KLeikert Ich m√∂chte allen Einsatzkr√§ften der Polizei und der Rettungsdienste danken Unser Hanau stand immer f√ºr Weltoffenheit und Zusammenhalt von Menschen aus 180 Nationen Wir werden nicht zulassen dass Menschen mit Migrationshintergrund Angst haben in unserem Land 	OTHER	OTHER
2/2 Im diesem Land muss die Vielfalt gewahrt werden Daf√ºr sind wir DemokratInnen verantwortlich betont Christine Lrecht und fordert auf unsere Demokratie jeden Tag zu verteidigen plenum rechtsterrorismus gegenhalten vielfalt spdbt 	OTHER	OTHER
Auch OlafScholz muss nun dringend Transparenz schaffenWir GrueneBundestag haben seinen mangelnden Ehrgeiz bei der Aufkl√§rung der kriminellen Cum-Ex-Gesch√§fte immer kritisiertangesichts der aktuellen Recherchen ist l√ºckenlose und z√ºgige Aufkl√§rung umso mehr ein absolutes Muss 	OTHER	OTHER
Bin jetzt ontheRoth nach Volkmarsen M√∂chte mir einen Eindruck von der Lage verschaffen mein Mitgef√ºhl ausdr√ºcken und den Sicherheitsbeh√∂rden f√ºr ihre Arbeit danken	OTHER	OTHER
142 Menschen sprechen üëáüèªüëáüèΩüëáüèø √ºber Hass TijenOnaran SerapGueler DjirSarai  viele mehr berichten in diesem bewegenden zeitonline-Projekt √ºber Rassismus in üá©üá™ Lasst uns alle zusammen f√ºr Offenheit k√§mpfen - wir sind EINE Gesellschaft wirsindhier 	OTHER	OTHER
DemoDavidLE FabioDeMasi Wir sind uns doch einig wie wichtig der Protest der Vielen gegen den Wahldeal der FDP mit der AfD war und das gewaltt√§tige Angriffe ein No-Go sind In Union und FDP m√ºssen sich die durchsetzen die eine dauerhafte Brandmauer gegen Faschisten wollen 	OTHER	OFFENSE
In d Oberlausitz sollen die Kleinsten jetzt also arabische Lieder h√∂ren Damit sie das nicht als fremd wahrnehmen So geht Islamisierung Mit Kinderliedern Es ist unglaublich wie wir uns freiwillig  selbst  abschaffen Nur die AfD h√§lt dagegen 	OFFENSE	OTHER
Die Flucht des T√ºbinger Hirnforschers Logothetis und seines Teams nach China ist ein gro√üer Verlust f√ºr unsere Wissenschaftslandschaft Die Freiheit von Forschung und Lehre ist in Deutschland auch von moralinsauren Shitstorm-Aktivisten bedroht fdpbt 	OFFENSE	OTHER
LaTravelle spdbt Ja hier wurde leider einiges vers√§umt Deshalb dr√§ngen wir ja auch auf den Rechtsanspruch Damit sich endlich was √§ndert	OTHER	OTHER
Beispiele f√ºr geballte‚úä Staatsfunkkompetenzü§™ü•≥Unabh√§ngig objektiv distanziert So ist Journalismus in üá©üá™ leider nichtNazitourette GEZ niewieder niewiederSozialismus 	OFFENSE	OFFENSE
Hoffentlich mischst Du Dich nicht ein 	OTHER	OTHER
Ich gratuliere bodoramelow zu seiner Wahl Es ist auch gut dass er der CDU die Hand ausgestreckt hat - und sie dem Faschisten H√∂cke verweigerte 	OFFENSE	OFFENSE
Die Linke hat gestern wieder verstaubtes Allheilmittel der umfassenden Verstaatlichung  Rekommunalisierung aus Mottenkiste geholt Warum das Quatsch ist habe ich in meiner Rede erkl√§rt Brauchen Konnexit√§tsprinzip  Wettbewerb aus Privat UND Staat 	OFFENSE	OTHER
janboehm Er kann es tragen üëçüèª	OTHER	OTHER
lemmanour SawsanChebli ManesWeissk SchulzAfD You are welcome ‚ò∫Ô∏è	OTHER	OTHER
Corona-Pandemie ist f√ºr Besch√§ftigte in Wissenschaft eine finanzielle Bedrohung weil 90% befristet sind Auch deswegen Hochschule|n besser ausstatten  WissZeitVG reformieren f√ºr soziale Sicherheit  zukunftsf√§hige Lehre Forschung Uni 	OTHER	OTHER
Mit dem Geschwafel zu rechtsfreien R√§umen und Clanstrukturen sch√ºrt _FriedrichMerz Vorurteile und Ressentiments - ich finden diesen Beitrag nach Hanau uns√§glich 	OFFENSE	OTHER
Bezeichnend dass dieLinke dagegen demonstriert dass wir den Mietendeckel vom Verfassungsgericht pr√ºfen lassen Merkw√ºrdiges Verst√§ndnis von Rechtsstaat - Verfassungsgem√§√ü ist eben nicht alles was ideologisch gepr√§gt von Linken beschlossen wird 	OTHER	OTHER
Wieder ein typischer Fall von unverantwortlichem Populismus und Antiamerikanismus  Ein Grund mehr warum dieLinke nie Regierungsverantwortung bekommen darf R2G GRR csu csu_bt cducsubt 	OFFENSE	OTHER
ChHarrison1 SilvaAtTwitta ZDFheute zB von hier 	OTHER	OTHER
Dorfkinder nicht gegen Stadtkinder ausspielen Nicht Ausl√§nder gegen Deutsche Nicht M√§nner gegen Frauen Wir m√ºssen mehr √ºber Gerechtigkeit bei Klima und Gesellschaft reden Kagne Linke 	OFFENSE	OFFENSE
Buongiorno aus Berlin heute Sitzungsmararhon im Bundesfinanzierungsgremium	OTHER	OTHER
fl0h0ff Stefan_LG Uh jetzt kommt das alte Gespenst	OTHER	OTHER
Die Waffenbeh√∂rden m√ºssen hier auch in Krisenzeiten auf der Basis des geltenden Rechts genau pr√ºfen ob die Antragsteller √ºber die n√∂tige Zuverl√§ssigkeit verf√ºgen damit Waffen nicht in falsche H√§nde geraten	OTHER	OTHER
Wir wollen bewaffnete Drohnen nicht so nutzen wie andere Nationen Sie dienen vor allem dem Schutz der eigenen Kr√§fte Ma√ügabe ist dabei sowohl Mandat des Bundestages aber vor allem das Selbstverst√§ndnis der bundeswehr Drohnendebatte2020	OTHER	OTHER
Schroeder_Live NEIN üòÇüòÇüòÇ	OFFENSE	OTHER
Die prophezeite gro√üe Corona Pause ist auch bei mir ausgefallen Ich hab jetzt weniger Termine daf√ºr deutlich mehr Doppelbelastung Denn Politik  Haushalt  Homeschooling ist nat√ºrlich auch f√ºr mich als Alleinerziehende Politikerin eine Umstellung 	OTHER	OTHER
Besser als BoB kann man es kaum formulieren bahnfrei 	OTHER	OTHER
Der Tag Sitzung des Ausw√§rtigen Ausschusses mit den Kollegen und Kollegen der Commission Affaires Etrangeres Obleutegespr√§ch Sportausschuss Sitzung der Inneren Kommission des √Ñltestenrates mit den gro√üartigen Kollegen S√∂nke Rix kahrs und der Kollegin Marianne Schieder 	OTHER	OTHER
Damit die Lebensleistung der stillen Helden unseres Landes endlich anerkannt wird haben wir die Grundrente heute im Bundestag beraten spdbt 	OTHER	OTHER
KMTaylorBerlin FerdaAtaman esrusch kuebra IdilBaydar CemileGiousouf NaikaForoutan Oezlem_Gezer SherminLanghoff WhiteBerlin36 euphrat_ EmiliaZenzile GomisSaraya clairelovescake JamieAfua aminajxx SharonDoduaOtoo sarahchander SelminCaliskan SawsanChebli üëåüèΩ	OTHER	OFFENSE
bodoramelow Ralf_Stegner 	OTHER	OFFENSE
KlaasTamme spdbt peteraltmaier Seltsam der Versto√ü gegen die Belegausgabepflicht ist doch gar nicht bu√ügeldbewehrt ü§î Viele Gr√º√üe vom Team Binding	OTHER	OTHER
Kevin K√ºhnert der keinerlei Hemmungen vor Koalitionen mit Linksextremisten hat erkl√§rt im MoMa der CDU seine Bedingungen f√ºr deren Kooperationsoptionen	OFFENSE	OTHER
BehmSteck KonstantinKuhle PS Begriff diskutieren wir gerne mal live ist komplexe aber sehr spannende Debatte Im Text ja auch bewu√üt zuerst mit Zusatz eingef√ºhrt	OTHER	OTHER
Bin gerade zur√ºck aus IstanbulBei jeder Prozessbeobachtung von Journalist*innen oder Oppositionellen wird mir wieder vor Augen gef√ºhrt wie wichtig es ist Demokratie und Rechtsstaatlichkeit gegen Antidemokrat*innen und Brandstifter zu verteidigen freethemall	OFFENSE	OTHER
CDU-Politiker bezeichnen WerteUnion als Krebsgeschw√ºr Wo die Meinung Andersdenkender in der Partei dazu f√ºhrt dass man auf ihre sprachliche Vernichtung abzielt sie ausgrenzt und verunglimpft ist der Aufl√∂sungsprozess innerhalb der Union weit fortgeschrittenAfD AKK 	OTHER	OTHER
Das Problem ist nicht die Methode Das Problem ist Merkel selbst Zeit dass sich die CDU von diesem Ballast befreit	OFFENSE	OTHER
Wenn f√ºr Dich minus 7% der Auftakt zu einer Siegesserie sind bist Du entweder Sozialdemokrat oder Du kannst nicht rechnen Vermutlich beides sPD Spezialdemokraten Hamburg Hamburgwahl hhbue  	OFFENSE	OTHER
Kinder ohne Waffen weltweit Kinder sollen in Schulen sitzen anstatt in Konflikten k√§mpfen Kinder sind keine Soldaten RedHandDay ChildrenNotSoldiers 	OTHER	OTHER
dieLinke In ihrer Partei wird im wohlwollenden Beisein ihres Bundesvorsitzenden dar√ºber disktutiert ob man 800000 Reiche lieber erschie√üen oder doch nur in Arbeitslager verbringen sollWerden sie die 800000 Namen nach ihrer Revolution auch nennen	OFFENSE	OTHER
In schwierigen Debatten zeigt sich der Charakter von Menschen Es gilt heute √ºber die Wahl des Ministerpr√§sidenten in Th√ºringen Meinungen anzuh√∂ren die nicht die eigene sind H√∂hnisches Gel√§chter Br√ºllen oder Beleidigungen bis zur Bezeichnung G√∂hring demaskieren die AfD	OFFENSE	OTHER
Falsch denn der Kern seiner Aussage ist dass er nur  eine freiwillige Selbstverpflichtung der Wirtschaft will Also csu wie immer More of the Same l√∂st aber nicht das Problem Schlachth√∂fe 	OTHER	OTHER
ismail_kupeli dieLinke Willkommen  Wann kommst Du auf einen Kuchen rum	OTHER	OTHER
Heute startet UNESCO mit dem Programm ResiliArt eine globale Debatte zu den Auswirkungen von COVID19 auf den Kulturbetrieb Wichtige Initiative unesco_de AA_Kultur goetheinstitut 	OTHER	OTHER
CduModerne cducsubt helgelindh Das meinen Sie hoffentlich nicht ernst Wer Gewalt rechtfertigt relativiert oder verharmlost der kann kein Demokrat mehr sein Und der hat offenbar auch noch nie Gewalt am eigenen Leib erlebtüôÑ	OTHER	OTHER
Was ist eigentlich aus der Reform der Gemeinn√ºtzigkeit geworden Herr OlafScholz Konkrete Vorschl√§ge liegen auf dem Tisch Unsicherheit ist Gift f√ºr die Zivilgesellschaft Gerade in der Krise sind viele Organisationen auf Spenden angewiesen 	OTHER	OTHER
2 Kaputte Universit√§ten und Br√ºcken n√ºtzen unseren Enkelkindern wohl kaum Die schwarze Null ist auch ein schwarzes Loch weil sie die etwa die Privatisierung von Autobahnen f√∂rdert die teuer f√ºr die Steuerzahler ist als jeder Kredit Tschentscher SPD Hamburg schwarzeNull	OTHER	OTHER
Polizeipr√§sidium M√ºnchen begr√ºndet Teilnahme von Polizisten bei Islamistenfeier mit Kontaktpflege Inakzeptabel Polizei braucht keine freundschaftlichen Kontakte zu Islamisten BayStMI muss nun klar zu diesen skandal√∂sen Vorg√§ngen Stellung beziehen	OFFENSE	OTHER
Der rechtspolitische Sprecher der SPD-Bundestagsfraktion Johannes Fechner fordert in der Bundestagsdebatte zur Reform des Strafrechts die Abschaffung des Paragraphen 219a Ich bin ganz bei ihm	OTHER	OTHER
liIkreutza Das hei√üt dann TB	OTHER	OTHER
Der Leichtmatrose Scheuer gibt Kommandos aber die Crew meutert Respekt den Beamten die ihren Berufsethos gegen diesen M√ºnchhausen verteidigen 	OFFENSE	OTHER
Sehr gut dass die IGMetall hier vorangeht Die Transformation muss auch politisch flankiert werden Unser Antrag dazu 	OTHER	OTHER
China versucht in der Corona-Krise durch knallharte Propaganda das eigene Image aufzupolieren und die Herkunft des Virus zu verschleiern Deutschland und die EU d√ºrfen sich das nicht gefallen lassen und m√ºssen den Versuchen chinesischer Einflussnahme eine klare Absage erteilen 	OFFENSE	OTHER
MixeD47 Ja Die Regierung ist am Zug Und die Opposition muss sagen was sie will Wir 	OTHER	OTHER
Bei meinem Besuch in Warschau habe ich viel √ºber die polnische Seele gelernt und gute Gespr√§che gef√ºhrt Meine dortigen Kollegen und mich eint der Anspruch mit unserer Europapolitik konkrete Verbesserungen f√ºr den Alltag der Menschen zu erreichen 	OTHER	OTHER
Das sind √ºbrigens die lustigen Kumpels vom heuteshow-Welke die die GEZ-Partei steuern 	OFFENSE	OTHER
Die Frage ist wirklich Wann bekommt die DeutscheBank ihr internes System f√ºr Geldw√§sche-Meldungen in den GriffJetzt droht weiterer Druck von den britischen Aufsichtsbeh√∂rden  ggf weitere Strafzahlungen 	OTHER	OTHER
Erst vergeht sich Erdogan mit dem Einmarsch in Syrien  am V√∂lkerrecht und die Konsequenzen darf jetzt Europa tragen Was hat die T√ºrkei in der EU verlorenmigrationT√ºrkischer Offizieller T√ºrkei wird syrische Fl√ºchtlinge nach Europa ziehen lassen 	OFFENSE	OTHER
Die fdp steht felsenfest in der Mitte  Klingbeil befeuert das Gesch√§ftsmodell der R√§nder mit seiner bescheuerten These Da w√§re ne Entschuldigung mal Gro√ü	OTHER	OFFENSE
Webinar mit ‚Å¶RamonaPop‚Å© und ‚Å¶grafwer‚Å© bei ‚Å¶gruene_berlin‚Å©  Spannend 	OTHER	OTHER
Dass sich die CDUMV einer Partei anbiedert deren oberste Funktion√§re freudestrahlend an Demonstrationen teilnehmen auf denen Deutschland verrecke skandiert wird und deren Jugendorganisation auf die Deutschland-Fahne uriniert sagt alles was die W√§hler wissen m√ºssen 	OFFENSE	OFFENSE
Herzlichen Gl√ºckwunsch an wanderwitz zur Ernennung als Ostbeauftragter der Bundesregierung Eine hervorragende Wahl und eine starke Stimme f√ºr den Osten Deutschlands üá©üá™üëèüèª	OTHER	OTHER
LeweMarkus muenster_de Danke f√ºr die Info Bin zuversichtlich dass wir das in M√ºnster so gut wie m√∂glich hinkriegen	OTHER	OTHER
Nakedchef1982 Ich antworte wie folgt 1 Der Versuch mit Herr Brandner als Ausschussvorsitzender war ja ein gutes Vorbild Nicht 2 Das mag so sein Ich w√§hle trotzdem keine Rechtsradikalen in hohe Staats√§mter	OTHER	OTHER
Mein Statement zur Steuersch√§tzung 	OTHER	OTHER
cducsubt verr√§t ihre √úberzeugung spdbt den kleinen Mann gemeinsam schneiden sie Verbraucherrechte ab- Hier meine gestrige Bundestagsrede gegen Zwangsgutscheine und f√ºr Wahlfreiheit	OTHER	OTHER
Ausgerechnet am Breitscheidplatz d√ºrfen sich diese Typen unbehelligt austoben Auf der Route des Todes ganz nah an den Morden des islamischen Terroristen AnisAmriWann wird gegen diesen Irrsinn von Regierungen der Altparteien von Polizei und Justiz vorgegangen 	OFFENSE	OFFENSE
Soll man da lachen oder weinen Ich bin immer wieder √ºberrascht welche abstruse Ideen mann haben kannCOVID19 coronavirusdeutschland 	OFFENSE	OTHER
Die biodeutsche taz-Redaktion kritisiert die mangelnde Diversit√§t im deutschen Handball Das ist typisch f√ºr die Links-Gr√ºnen LangstreckenLuisa gegen das Vielfliegen Linke Eltern f√ºr Multikulti-Schulen aber nicht f√ºr die eigenen Kinder Doppelmoral 	OFFENSE	OFFENSE
Studentinnen der FH Kempten wendeten sich mit einem dramatischen Appell an mich Es geht um sexuelle Bel√§stigungen und ein beklemmendes Klima auf dem Cus Aber Keine Angst Wir k√ºmmern uns drumAlle sind gegen uns weil wir f√ºr Euch da sind AfD ‚Å¶AfD_Bayern‚Å© 	OFFENSE	OTHER
SchamsEU DB_Presse RegSprecher GreensEFA GrueneBundestag Elisabeth_Borne alainkrakovitch DominiqueRiquet GroupeSNCF SNCB Merci	OTHER	OTHER
am_schnack Anja wir sollten Kaffee trinken Ich mache dir ne Namensliste vorher fertig	OTHER	OTHER
Die Chaostruppen CDU  FDP verlangen in Thueringen einen Konsenskandidaten Wir h√§tten da einen In welcher Parallelgesellschaft leben die  	OFFENSE	OFFENSE
Nach dem Angriff auf die Menschlichkeit kommt der Angriff auf den Menschen Und beidem stellen wir Gr√ºne uns mit aller Kraft entgegen - starke Rede von Claudia Roth beim pam20 der gruenenrw 	OTHER	OFFENSE
Gute Nachricht f√ºr die Verkehrssicherheit Auch der DVR fordert jetzt ein generelles Tempolimit von 130 km/h auf der Autobahn 	OTHER	OTHER
Die Unionsfraktion will die Chancen von blockchain nutzen und deren Rahmenbedingungen aktiv gestalten Auf unserem Meet  Greet haben wir mit StartUps und Experten diskutiert heckerhut vom bundesblock war als Redner dabei +++ Jetzt Video anschauen üì∫‚¨áÔ∏è 	OTHER	OTHER
lyssaslounge jenssiegert TooScott2Trot wutrain ewarren Zu klug gibt es als Vorwurf auch an M√§nner Denken Sie mal an Gerhard Schr√∂der und seine herabw√ºrdigenden Bemerkungen √ºber Professor Kirchhof Das Thema Stimme dagegen da haben Sie recht ist fast ausschlie√ülich gegen Frauen gerichtet	OTHER	OTHER
ReussWillhelm AKress84 Das ersetzt keinen Job und ist ohne Menschen die Geld verdienen und Steuern zahlen nicht im Ansatz finanzierbar	OTHER	OTHER
Nordkurier Mit Rechtsradikalen rede ich nicht	OTHER	OFFENSE
HGMaassen Wir werden am Nasenring durch die Manege gef√ºhrt Erstaunlich ist wieviele Menschen diese Besch√§ftigungals angenehm empfindenüßêCOVID19deutschland COVID„Éº19LockdownExtended Drosten RKI WHO WHOLiedPeopleDied	OFFENSE	OTHER
Alles bekannt Und doch super aufr√ºttelnd und super wichtig Mehr von solchen √ºberraschenden und aufkl√§renden Formaten auch im Unterhaltungsfernsehen  maennerwelten	OTHER	OTHER
Die T√ºrkei f√ºhrt in Syrien v√∂lkerrechtswidrig Krieg gegen Kurden und kooperiert mit AlQuaida K√§mpfern - dabei soll ihr nun die NATO helfen Irre   	OFFENSE	OTHER
Den Angriff auf J Milaschina und M Dubrowina verurteile ich auf das Sch√§rfste Meine Erkl√§rung zum Vorfall in Grosny am 6 Februar 	OTHER	OTHER
Greta Thunberg und Donald Trump haben mehr gemeinsam als ihnen lieb ist Sage ich ja angstUnternehmer  	OTHER	OTHER
freyga5 UlrichSchneider Das soll sie bitte ihrer Bundesregierung sagen	OTHER	OTHER
Ist es Lage der Nation angemessen dass BILD vor Parlament  √ñffentlichkeit √úberlegungen Bundesregierung zu Kontaktverbot  Lockerungen erf√§hrt Was sind Spekulationen und Leaks f√ºr ein Umgang mit den Leuten die um ihre Existenz bangen 	OTHER	OTHER
fbanaszak Der Typ ist auf Platz 20 Solange Leute ihn nicht pers√∂nlich w√§hlen - was unwahrscheinlich ist - wird er nicht einziehen Daher ist ihr Post eine widerliche Diffamierung der Partei DIE LINKE Diese hat sich klar von Radtke distanziert ein Ausschlussverfahren l√§uft	OFFENSE	OTHER
Ordentlich ein paar Folgen f√ºr die Zugfahrt auf das iPad laden und es dann im Hotel vergessen Kann ich ü§¶üèº‚Äç‚ôÇÔ∏è	OTHER	OTHER
Demokraten m√ºssen zusammenhalten üí™üí™ vor allem gegen die AfD und gegen Leute wie AfDLindemann und StBrandner noAfD 	OTHER	OTHER
MatthiasMeisner lepettre Was hat KemmerichThL denn darauf geantwortet	OTHER	OTHER
Folge 02 von StrasserL√§dtEin mit MAStrackZi findet ihr jetzt auf meinem YouTube Kanal Viel Spa√ü beim reinschauenüëâüèª	OTHER	OTHER
Das ist Deutschland heuteAlles Nazi was nicht pa√ütüôÑKrfgegenRechts 	OFFENSE	OFFENSE
Sollte die SPD und B√ºndnis90 die Gr√ºnen heute Herrn bodoramelow zum Ministerpr√§sidenten von Th√ºringen w√§hlen sollte sofort der Verfassungsschutz aktiv werden dieLinke fordert den Mord zumindest ein Gulag f√ºr 1% der Bev√∂lkerung AfD w√§hlen f√ºr Freiheit	OFFENSE	OTHER
Bitte Fakten statt Gef√ºhltes ZDFheute Wer in D den Spitzensteuersatz von 42 Prozent auf das zu versteuernde Einkommen bezahlen muss verdient rd 46000 Euro im Monat Wer 5000-7000 Euro im Monat hat zahlt rd 30 Prozent 	OTHER	OTHER
KaiPfannebecker üôâTW	OTHER	OTHER
HeikoMaas Eine der besten Investitionen im Kf gegen die Pandemie ist es die Vereinten Nationen üá∫üá≥ allen voran die unterfinanzierte Weltgesundheitsorganisation WHO  zu st√§rken zum Beispiel bei der Entwicklung und Verteilung von Tests und Impfstoffen 	OTHER	OTHER
MartinBartelhei Naive Vorstellung dass Gabriel der jahrelang Parteichef der SPD war der f√ºr die SPD Vizekanzler war der jahrelang f√ºr die SPD im Bundestag sa√ü nun ein Privatmensch sein soll Nat√ºrlich f√§llt es auf die SPD zur√ºck wenn ein einstiger Spitzenpolitiker so ein Amt annimmt	OFFENSE	OTHER
OlafScholz will die Schuldenbremse des Grundgesetzes au√üer Kraft setzen Obwohl der Staat Steuer√ºbersch√ºsse erzielt will er mehr Schulden machen Die engen die Spielr√§ume der jungen Generation ein Das wird es mit den Freien Demokraten nicht geben 	OFFENSE	OFFENSE
JoePaperboy GeorgStieler Oha üòè Do it üòâ	OTHER	OTHER
Ja wir Dorfkinder sind schon ganz cool Aber lieber als hippe Share Pics sind uns schnelles Internet funktionierender √ñPNV ne gute √Ñrzteversorgung und ordentliche Freizeitangebote 	OTHER	OTHER
lutzwildermann Stimmt	OTHER	OTHER
doc3008 Susanne45217800 webmonster Julia42833681 spdde spdbt spd_netzpolitik Open Source muss es sein und soweit ich wei√ü haben sich CCC und heise zu  Technologie und Konzept auch schon zustimmend ge√§u√üert	OTHER	OTHER
Traenaer Wie zu erwarten war Paulanergarten Sie meine Dame sind ein Trollaccount der mich von der Arbeit abhalten soll Arrivederci	OFFENSE	OFFENSE
BMJV_Bund Das sollte auch thematisiert werdenüòâ 	OTHER	OTHER
Sie und  ihre betreuenden Personen brauchen ausreichend Schutzkleidung und sind in besonderem Ma√üe darauf angewiesen dass alle anderen die Hygienevorschriften einhalten	OTHER	OTHER
otto_direkt Und wer keine Mikrowelle hat	OTHER	OTHER
Coronavirus und Migrantenstr√∂me doch Merkel schweigt Frau Kanzlerin treten Sie zur√ºck und machen Sie den Weg frei Deutschland braucht jetzt eine starke und vern√ºnftige Regierung Nur noch AfDArtikel 	OFFENSE	OTHER
pflegekraft_ms GrueneBundestag K_SA Sehr viele fundierte Forderungen - und allem voran die St√§rkung der Profession	OTHER	OTHER
MonikaHerrmann1 Es zwingt Sie keiner in unserem christlich-j√ºdischen gepr√§gten Land zu leben Der letzte gottlose Staat bei uns war die DDR Wollen sie den wieder haben	OFFENSE	OTHER
Die letzte Woche im Deutschen Bundestag war wieder einmal hart  Wer Union und FDP w√§hlt unterst√ºtzt Parteien die sich dem linken Zeitgeist anbiedern linken Parteien zur Macht verhelfen  LINKE Sozialismus AfD  	OFFENSE	OFFENSE
Kommunismus = Holodomor SED = Mauermord Mord war immer eine Option f√ºr Stalinisten von dieLinke Sinnvolle Arbeit f√ºr Reiche b_riexinger meint Gulag Die verbrecherischen Ziele von die Linke liegen offen Unterst√ºtzt CDU das in Thueringen 	OFFENSE	OFFENSE
EricE2017 DonkeyK111 SvenjaSchulze68 NowaboFM hubertus_heil Auch Stra√üen Br√ºcken KiTas und Schulen werden von Leuten mitfinanziert die zuhause sitzen und √ºberhebliche Tweets in die Tastatur hauen Sch√∂nen Tag noch	OFFENSE	OTHER
Besch√§mendDie eine Seite instrumentalisiert die Gefl√ºchteten als Hebel zur Durchsetzung eigener geostrategischer Interessen die andere Seite versucht sie sich mit √§hnlicher Entschlossenheit vom Leib zu halten als handle es um ein neuartiges schwer ansteckendes Virus Europa 	OFFENSE	OTHER
Luebeck noafd rechtsterror 	OTHER	OTHER
Ganz ganz starke pers√∂nliche Rede meines Freundes Bijan DjirSarai heute im Bundestag - √ºber seine Heimat und was nach Hanau und Co auch in ihm vorgeht Egal ob Bilal oder Bijan egal ob Ay≈üe¬†oder Annika - wir sind EINE Gesellschaft und m√ºssen zusammen stehen 	OTHER	OTHER
Berlin Besuch im B√ºro Baumann - Bernd hatte f√ºrs Foto leider keine Zeitüòâ Danke auch f√ºr den leckeren Kaffee ‚òïÔ∏è üëç - komme gerne wiederAfD Berlin Bundestag Brandner 	OTHER	OTHER
aluhutt Ich bin Trendsetterin11elf	OTHER	OTHER
gelbhaar LINKEPELLI Quatsch Lesen Sie meine Tweets Dann k√∂nnen Sie sich Ihr Sch√§men n√§mlich sparen Ich stehe klar gegen jede Art von Extremismus Hier fand aktuell linke Gewalt statt und auf die habe ich hingewiesen Zum Mord an W L√ºbcke habe ich mich √ºbrigens mehrfach ge√§u√üert	OFFENSE	OTHER
reitschuster Mit dem Unterschied dass die AfD √ºberhaupt niemanden jemals eingesperrt hat	OTHER	OTHER
venghaus16 Apokalypse braucht keine Bildung	OTHER	OTHER
dneuerer UlrichKelber 	OTHER	OTHER
_donalphonso 1 Unlustig Voll 2 Doof In Ostafrika ist keine Steppeulfposh petze aber nicht beim Chef	OFFENSE	OFFENSE
Lobbyismus pur Gabriel hat Banken einmal Erpressung von Staaten vorgeworfen jetzt nimmt er hochbezahlten Aufsichtsratsposten bei DeutscheBank an So wird Vertrauen in d Demokratie bald endg√ºltig verspielt Dreht√ºr zwischen Politik  Lobby schlie√üen 	OTHER	OTHER
WasserIsSehrGut RMN_PG Diether_Dehm HeikeHaensel ZaklinNastic Andi_Wagner AlexanderSNeu ZdebelHubertus Das ist ein v√∂llig unzul√§ssiger Vergleich und eine Relativierung des Holocaust Und ja Rechtsstaat V√∂lkerrecht Menschenrechte und das ganze vermeintlich b√ºrgerliche Zeug gelten nicht nur f√ºr die Guten	OFFENSE	OFFENSE
stfnsen AnneWillTalk Es gibt das hier Aber er wurde im Beisein von Journalisten von Abgeordneten konfrontiert die ihm klar gesagt haben sie helfen 5 Prozent Kemmerich nicht mit Absprachen aus der Patsche Von wegen Mehrheit jenseits AfD Das hat ihn nicht gekratzt 	OFFENSE	OTHER
fdprlp Och Leute verkauft doch die Menschen nicht f√ºr dumm F√ºr einen Beschluss muss man mehr als 50 % haben Koalitionspartner dadurch immer Veto-Spieler Zudem ihr habt euch ja bei den Stra√üenbeitr√§gen gerade nicht durchgesetzt	OFFENSE	OTHER
Nun bekommt Prasanna Gettu den AnneKlein Frauenpreis in der HBS Die Rechte der Frauen in Indien ‚Å¶Frauenrat‚Å© ‚Å¶ulle_schauws‚Å© 	OTHER	OFFENSE
SebastianRdbl Hallaschka_HH HeikoMaas akk Er ist kl√ºger geworden Sicherheitszone	OTHER	OTHER
Wir fordern schon lange dass die verbrecherische deutsche Kolonialgeschichte endlich umfassend aufgearbeitet werden muss jankortemdb  Dazu geh√∂rt auch die Kl√§rung der Herkunft von Museumsbest√§nden und ggf R√ºckgabe 	OTHER	OFFENSE
SaschaKonigl AfD_HD b_riexinger drumheadberlin K√∂nnen sie das irgendwie n√§her erl√§utern So wie sie das schreiben wirkt das auf mich etwas rathjenesk	OTHER	OTHER
Hallaschka_HH Tagesspiegel Tsp_Spandau Es gab keinerlei Absprache Die SPD musste sich zu einem Antrag verhalten und hat ihn aus sachlichen Gr√ºnden abgelehnt Das ist etwas v√∂llig anderes als sich zur Wahl zu stellen wissend dass man nur mit AfD-Stimmen gew√§hlt werden kann - und die Wahl dann auch noch annehmen	OTHER	OTHER
Pandemien haben Auswirkungen auf Wirtschaft  nat√ºrlich auf Menschenleben Wir m√ºssen schauen wie wir damit umgehen sagt jensspahn im Tagesspiegel Das unterstreicht dass das BMG_Bund keinen Plan f√ºr weitere Arzneimittel-Lieferengp√§sse hat üëéüò±COVID19	OTHER	OTHER
Riskanter Lockerungsfahrplan der BuReg Erst m√ºssen zus√§tzliche Ma√ünahmen sichergestellt sein wie zB Mundschutzpflicht in Bus  Bahn regelm√§√üiges Testen von gef√§hrdeten/exponierten Berufen  Produktion der Masken Sonst steigen Infektionen wieder 	OTHER	OTHER
Syrien Eingekesselte gem√§√üigtere Rebellen der letzten Jahre haben sich der syr Regierung ergeben die Ultra-Islamisten hingegen wurden mit Bussen nach Idlib verbracht wo sie bis zuletzt k√§mpften Diese wollen jetzt nach Europa migrieren - weiterlesen 	OTHER	OTHER
MarcusJogerst Pflegeff HasselerMartina Einerseits Aber Politik wird auch mit und durch Interessenvertretung gemacht Und da fehlt die Pflege	OTHER	OTHER
Die Aufgabe von Frau Chebli ist gerichtlich gekl√§rt Quotenmigrantin der SPD sagen andere Ich sage Die SPD ist der verl√§ngerteArm des politischen Islam in Deutschland 	OFFENSE	OFFENSE
annamakoll solms YouTube Wenn ich wieder etwas n√§her an den Solms ran kann üò∑ü§ì	OTHER	OTHER
Gewalt an der Grenze Heftige Zusammenst√∂√üe zwischen griechischer Polizei und Fl√ºchtlingen 	OTHER	OTHER
Alex13921861 dieLinke Die FDP in Th√ºringen hat weder Herrn H√∂cke noch Herrn Ramelow gew√§hlt TW	OTHER	OTHER
Was reitet eigentlich den ArminLaschet CDU Oder ist das auch ein virus Laschet fordert Lockerung der Quarant√§nepflicht  	OFFENSE	OFFENSE
Wenn man zusammentr√§gt was es hier an Kommentaren zu CKemfert gibtblau√§ugig distanzlos verniedlichend verantwortungslos  reine Wunschvorstellungen alles v√∂llig falsch dieser Disziplin nicht w√ºrdig kann man nur sagen Sorry Jungs das ist echt schlechter Stil 	OFFENSE	OTHER
Nico Du bist vom Weg abgekommen üò≥	OFFENSE	OTHER
FelixWf29 Danke f√ºr die Meinung TB	OTHER	OTHER
Sag mal n-tv geht‚Äôs noch Option bei Wiederholungst√§tern K√ºnast bef√ºrwortet Gef√§ngnis f√ºr Hass-Posts - 	OFFENSE	OFFENSE
Kopftuchverbot im Gerichtssaal verfassungsgem√§√ü Gute u richtige Entscheidung ‚Äì Staat muss politisch/religi√∂s neutral sein Justiz √ºbt Hoheitsgewalt aus damit vertr√§gt sich Kopftuch nichtcducsubt Tagesspiegel csu_bt cduberlin handelsblatt CDU 	OTHER	OTHER
Marxzell-Pfaffenroth LKW-Durchfahrverbot f√ºr Gefahrguttransporte umgehend pr√ºfen 	OTHER	OFFENSE
Guten Morgen Deutschland Faszinierend wie schnell der deutsche vergisst Bitte immer dran denken die Linke ist die SED und bodoramelow ist Kommunist	OFFENSE	OFFENSE
Hier sind aktuelle Zahlen zu COVID19de-Erkrankungen in meinem regionalen Zust√§ndigkeitsbereich Durch die Einschr√§nkungen der letzten Wochen konnten wir die Ausbreitung des Virus bereits verlangsamen Danke f√ºrs Durchhalten und an alle die tatkr√§ftig helfen üôèüèΩ CoronaUpdate 	OTHER	OTHER
 hat jetzt √ºber 24 Stunden von Emsdetten nach Berlin gebraucht und bedankt sich bei allen die mitgeholfen haben dass bei Sabine offenbar niemand ernsthaft zu Schaden gekommen ist üå¨	OTHER	OTHER
Reden ist Silber Handeln ist Gold fdpbt handelt so wie wir es von anderen erwartenüí™ gr√ºne reden Ma√ünahmen ohne Wirkung herbei die dann andere umsetzen sollen ü§î	OTHER	OTHER
Der Hammer Abschiebung|en von Asyl|forderern nach Italien Dublin-Verfahren werden wegen Coronavirus ausgesetzt Gleichzeitig bleiben die Grenzen f√ºr Zuwanderung auch aus gef√§hrdeten Gebieten offen Das ist Inl√§nderfeindlich|e Politik / Q 	OFFENSE	OTHER
Dem ist nichts hinzuf√ºgen 	OTHER	OTHER
Aber mittel- und langfristig m√ºssen wir uns um die Lage in Syrien k√ºmmern EU darf sich nicht erpressen lassen sondern muss als einheitlicher Akteur auftreten Nicht nur reagieren sondern agieren	OTHER	OTHER
Fisheye2k kuebra Die Buchhandlung ist ja unabh√§ngig aber wegen der N√§he zur Politik hat sie ein Angebot dass sich sehr am Parlamentarischen orientiert	OTHER	OTHER
tazgezwitscher In einigen asiatischen L√§ndern  zB Vietnam seit Wochen Schulen und Universit√§ten geschlossen	OTHER	OTHER
TheBruzzzler Stimmt wenn das so einfach w√§re Unsere M√ºtter haben es uns allen eigentlich immer erkl√§rt -	OTHER	OTHER
Brutale Attacke in Landshut ‚Äì Opfer erleidet erhebliche Kopfverletzungen Goldst√ºcke am Werk Ich wusste gar nicht dass √Ñrzte und Ingenieure unschuldige Leute auf der Stra√üe verpr√ºgeln 	OFFENSE	OTHER
PoLILYtik LVZ SPDLeipzig H√§h Lies selbst noch mal Du meinst wir m√ºssen uns freuen dass du jetzt nicht mehr ohne Belege behauptest SPDler h√§tten dich bedroht sondern nur noch ohne Belege von subtiler Drohkulisse sprichst Sagt mal hackt‚Äòs bei euch allen Hier ist ne Entschuldigung f√§llig	OFFENSE	OTHER
Warum sollten sie das tun Die Genossin hat nur ausgedr√ºckt was das Konzept des Sozialismus ist Unter sichtlichem Wohlwollen des Bundesvorsitzenden RiexingerNicht die SED sollte die Genossin ausschlie√üen der Verfassungsschutz sollte die Linke ausschlie√üenSEDverbot 	OFFENSE	OFFENSE
Nazis raus ‚úä Hamburgwahl NoAfD	OTHER	OTHER
Im vergangenen Jahr ist auf deutschen Autobahnen f√ºr Baustellen insgesamt 130 Mal eine komplette Fahrtrichtung gesperrt oder sogar die ganze Autobahn dicht gemacht worden Es scheint in diesem Staat ein neues Feinbild zu geben und das ist der Autofahrer	OTHER	OTHER
Was ist da dran Aufkl√§rung ist dringend n√∂tig in Sachen Warburg und CumEx Hamburg SchickGerhard sven_giegold 	OTHER	OTHER
f_rtz Das geht aus meiner Antwort hervor oder Das Ergebnis sehen wir jetzt die Abschaltungen werden nicht linear erfolgen die Emissionen √ºber die Zeit werden nochmal wesentlich h√∂her sein als im sog Kompromiss	OTHER	OTHER
Soso Kritiker der Passwort-Rausgabe sind also hirnrissig Fachleute die die B√ºrgerrechte bedroht sehen seien Handlanger der T√§ter Geht‚Äòs noch Die SPD man√∂vriert sich immer mehr ins Aus 	OFFENSE	OFFENSE
Druck wirkt Gut dass die Gesichtserkennung offenbar aus dem Bundespolizeigesetz verschwunden ist Diese Methode darf in Deutschland nicht zum Einsatz kommen Die B√ºrgerrechte m√ºssen in Zeiten der Digitalisierung entschieden verteidigt werden fdpbt  	OTHER	OTHER
Merkels neuer Ostbeauftragter belehrt OstdeutscheMarco Wanderwitz Merkels neuer Erzieher f√ºr die jungen L√§nder meint Ossis fremdelten damit dass Mehrheitsentscheidungen akzeptiert werden m√ºssen Ein schlechter Wanderwitz 	OFFENSE	OTHER
Vorbereitung der Plenarwoche im B√ºro Themen und Termine Gleich zur Werkstattkonferenz der cducsubt Inklusion Bundestag	OTHER	OTHER
Sehr erleichtert Gl√ºckwunsch an bodoramelow Jetzt hat das Chaos ein Ende und Th√ºringen endlich wieder eine Regierung Und zwar ohne Handschlag mit Faschisten	OFFENSE	OFFENSE
EtgetonStefan Alice_Weidel AfDimBundestag BAEKaktuell DLF Danke f√ºr die Einordnung COVID„Éº19 Keine Instrumentalisierung NoAfD	OFFENSE	OTHER
Jetzt wird es langsam HuxleySch√∂ne Neue WeltDie alte Oma-Umweltsau soll weniger Fleisch essenWeniger FleischWeniger CO‚ÇÇMehr Profit f√ºr die Alten-VerwahranstaltenKopfsch√ºttelnd  zornig Bochum AWO Seniorenheim	OFFENSE	OTHER
Bei AnneWill behauptet Kubicki er sei mental st√§rker als Kemmerich Er will den Eindruck erwecken wie auch Lindner es w√§re ein spontaner Fehler Kemmerichs gewesen Das zeigt erneut wie verlogen die FDP ist Jeder weiss doch inzwischen da√ü auch das AfD Szenario besprochen war	OFFENSE	OTHER
Hanau ist kein Einzelfall Auch vorherige rechtsextremistisch motivierte Straftaten haben gezeigt dass Deutschland eine Offensive gegen rechtes Gedankengut Hass und Hetze braucht	OTHER	OTHER
katluetz BPfefferlein AnjaSiegesmund Und diese Zahlen m√ºssen echt besorgen	OTHER	OTHER
Wir lassen uns nicht einsch√ºchtern ‚úäüèª 	OTHER	OTHER
Wer als Sportsch√ºtze Waffen besitzt muss seine Eignung in jeder Hinsicht nachweisen Die Koalition muss jetzt die von Seehofer nach dem rechtsterroristischen Anschlag von Hanau geforderte umfassende Eignungspr√ºfung f√ºr Waffenbesitzer umsetzen 	OTHER	OTHER
Nachdem ein hochrangiger t√ºrkischer Beamter gegen√ºber Reuters erkl√§rte dass syrische Fl√ºchtlinge nicht l√§nger gehindert werden nach Europa zu gelangen werden kostenlose Busse bereitgestellt die von Istanbul an die bulgarische Grenze fahrenAfD 	OTHER	OTHER
Dieser Gru√ü aus dem BMFSFJ muss den M√ºttern zynisch vorkommen Es w√§re Zeit dass das BMBF_Bund auch Gro√üartiges leisten w√ºrde - ein coronaelterngeld f√ºr die CoronaEltern ist l√§ngst √ºberf√§llig 	OFFENSE	OTHER
Skorwider_Heinz violine1909 Es gibt Freibetr√§ge die nicht versteuert werden m√ºssen Dar√ºber bezahlt man f√ºr die ersten Euros einen Steuersatz von 14% der f√ºr die weiteren Euros ansteigt bis 42% Das nennt sich Progression So ergibt sich der individuelle Durchschnittssteuersatz 	OTHER	OTHER
Die grausamen Anschl√§ge in Afghanistan der letzten Tage sind ein herber R√ºckschlag f√ºr den Friedensprozess und zeigen dass die Menschen vor Ort noch lange nicht in Frieden leben k√∂nnen BReg muss endlich ihre Afghanistanpolitik evaluieren 	OTHER	OTHER
beimwort btw ein angemessene W√ºrdigung in der Zeit bertpsch	OTHER	OTHER
Hatte 13 Personen in meinen letzten B√ºrgersprechstunden Nur zweimal war Coronakrise direkt Thema Keine Verschw√∂rungstheorien Teils kontrovers Alles sachlich Hat gut getan Trauen sich Verschw√∂rungstheoretiker nur im Netz und in der Masse unter ihresgleichen sich zu √§u√üern	OTHER	OTHER
beimwort Was soll denn an einer Enthaltung eine Totalblockade sein Die Verfassung sieht doch bei m√º√üte 3 Wahlgang eine L√∂sung vor	OTHER	OTHER
jsuedekum MakronomMagazin √úbrigens damit wir auch da klar sind eine Stadt wie Duisburg mit ihrem Einwohnerschwund und ihrer  Wirtschaft Hat sicher Hilfe n√∂tig Frage ist nur welche und sie muss fair sein gegen√ºber den anderen	OTHER	OTHER
Sind das die Werte der CDU Die Werte-Union freut sich dass eine wahrhaft mutige muslimische Frau die diesen Staat repr√§sentiert als  ¬´Quotenmigrantin der SPD¬ª und ¬´islamische Sprechpuppe¬ªbezeichnet werden darf Liebe SawsanChebli Du hast unsere volle Solidarit√§t	OTHER	OFFENSE
Es sind schwierige EntscheidungenX die immer den Fokus der Gesundheit im Blick haben Hier gibt es im Detail nachzulesen welche Lockerung zu Corona der Senat beschlossen hat 	OTHER	OTHER
AFD-Landtagsvizepr√§sident handelte rechtswidrig In Brandenburg versuchte er eine Debatte √ºber Rechtsterror und Rassismus zu verhindern Das gelingt ihm nicht Es zeigt aber einmal mehr wes Geistes Kind diese AFD-Leute sind Rechtsstaat NoAFD 	OTHER	OTHER
Wir machen die berufliche Bildung fit f√ºr die Zukunft Heute wurde im Bundestag die Novelle des AufstiegsBAf√∂G beschlossen Damit steigern wir die Attraktivit√§t der beruflichen Bildung und tragen weiter zu der Gleichwertigkeit der akademischen und beruflichen Bildung bei 	OTHER	OTHER
D_FLAKOWSKI cducsubt Bei namentlichen Abstimmungen wird nur gewertet wenn man abgestimmt hat also nix mit Tagtr√§umen  üòâ	OTHER	OTHER
Das zeigt die Rechtsstaatlichkeit im Fall der Musikband Grup_YORUM ist nicht gew√§hrleistet Trotzdem werden diese Faschisten es nicht schaffen GrupYorum und ihre Millionen Fans zum Schweigen zu bringenSolidarit√§t mit Grup Yorum GrupYorumaSesOl 	OFFENSE	OFFENSE
PhilVloggt Max97144158 Sorry aber langsam wird es wirklich absurd Was sollen solche pauschalen und vollkommen haltlosen Anschuldigungen Die bringen uns sicher nicht weiter und heizen die Stimmung nur noch mehr auf Sinnvoller w√§re es endlich mal sachlich zu argumentieren TB	OTHER	OTHER
g_reichenbach KingKon55654238 Von F√§lschungen mal gar nicht zu reden	OTHER	OTHER
Ab heute sind Sie aufgefordert uns zu helfen 5 Woche lang l√§uft die Onlinekonsultation zur Datenstrategie unter 	OTHER	OTHER
Der Staat muss sich in kritische Infrastruktur wie die √úbertragungsnetze einmischen Ich pl√§diere f√ºr mehr Netze in √∂ffentlicher Hand 	OTHER	OTHER
hass gegen Minderheiten ist immer problematisch auch gegen Reiche  	OTHER	OFFENSE
Guter Austausch  gro√üe √úbereinstimmung in den zentralen aktuellen Themen Europas zwischen dem neuen EVP-Vorsitzenden donaldtuskEPP  unserem Parteivorsitzenden Markus_Soeder in M√ºnchen CSU EPP Europe 	OTHER	OTHER
Der Staat hat seine schwarze Null auf Kosten der arbeitenden Bev√∂lkererung erwirtschaftet Durch Niedrigl√∂hne und hohe Abgaben in zehn Jahren Aufschwung Jetzt will Gabriel die Mittelschicht noch mal schr√∂pfen Das ist nicht sozial das ist das Gegenteil 	OFFENSE	OFFENSE
Kl94Smr Hat aber schon immer luschig aus der W√§sche geguckt	OTHER	OTHER
Wir d√ºrfen nicht zulassen dass den Held*nnen wieder nur der Applaus bleibt Schutzkleidung Recht auf regelm√§ssige Testung leistubgsgerechte Bezahlung genug Personal und weniger Belastung pflegebonus darf nicht zum Trostpflaster verkommen 	OTHER	OTHER
+++Wieder 5Fragen5Antworten zu politischeKorrektheit+++Nationalhymne umschreiben Stra√üennamen verbieten Fasching nicht mehr feiern Balkan- oder Zigeunerschnitzel5F5A AfD Berlin AfDwirkt nurnochAfD Brandner Altparteien Berlin	OTHER	OFFENSE
Bin mit vielen meiner EU-KollegInnen im Kontakt üá™üá∫ schaut auf uns auch wegen unserer Nazi-Vergangenheit Wie gehen wir in üá©üá™ mit Nationalisten um Sie durch politische Einbindung entzaubern w√§re ein Verrat an unserer Geschichte Deshalb braucht es Haltung  klare Abgrenzung	OTHER	OTHER
Watchu28020892 OlafGersemann dneuerer welt mvankerkhove DrTedros Sorry aber was wollen Sie konkret	OTHER	OTHER
la_france1 Rootz23 Gedankenleser84 cducsubt Nat√ºrlich sage ich das sehr offen und auch pers√∂nlich Empfehle Ihnen zB 	OTHER	OTHER
Wer jetzt  Schutz organisieren will ist bestens beraten das im Rahmen geltender Gesetze zu tun Erleichtert die zeitnahe Umsetzung ü§ó TracingApp 	OTHER	OTHER
HamburgWahl noAfD HHWahl nonazis NazisRaus 	OFFENSE	OTHER
kattascha Volksverpetzer ü§£	OTHER	OFFENSE
svenseele Die war allerdings nicht mehr aktuell ü§£	OTHER	OTHER
Wenn AfD f√ºr einen Demokraten stimmt muss dieser zur√ºck treten W√§hlen die exakt selben einen Kandidaten der Schie√übefehl Zwangsadoption und Hohensch√∂nhausen nicht als Unrecht‚Äù bewertet ist das legitim Gehts noch taz 	OFFENSE	OTHER
Es ist ein gutes Zeichen dass sich der ehemalige sudanesische Pr√§sident Omar al-Baschir jetzt in Den Haag vor dem ICC verantworten muss Kriegsverbrechen und V√∂lkermord d√ºrfen niemals unges√ºhnt bleiben 	OTHER	OTHER
ColinvonE TAOnline jana_hensel melltstone nextbike cbollert Absolut Der Abend war sozusagen zu kurz	OTHER	OTHER
Sitzungswoche Bundestag beginnt in Dresden Taufe eines neuen ICE 4 auf den Namen Freistaat Sachsen Sch√∂n Auch sch√∂n In allen Reden Hinweis auf Ausbau/Elektrifizierung Chemnitz-Leipzig Wichtig-es geht voran Stadt_Chemnitz MPKretschmer MartinDulig DB_Presse DB_Bahn 	OTHER	OTHER
Da√ü das Stasispitzel erfreut wundert mich nicht 	OFFENSE	OFFENSE
WqiRnRL9ot7F0zj gerda_alice ü§¶üèº‚Äç‚ôÇÔ∏è	OTHER	OTHER
So kennt man unsere Kanzlerin 	OTHER	OTHER
Gewalt  Hass gehen nie  gar nicht Nicht gegen Mitglieder  Anh√§nger der FDP nicht gegen Menschen anderer Parteien oder Meinungen nicht gegen B√ºrgermeister j√ºdische Mitb√ºrger oder Migranten Nie  gar nicht  Solidarit√§t M√§√üigung	OTHER	OTHER
Rotongo1 fegebanks hkhamburg Buchkolumne kuebra mareikeengels till_steffen GRUENE_Hamburg GRUeNE_Altona Reg Dich ab Ich war da	OFFENSE	OTHER
G√∂ring-Eckardt spricht Neben mir murmelt eine FDPlerin eingeschnappt Die sollen mal unser Programm lesen da steht drin f√ºr was wir stehen Mein leicht sarkastisches Willkommen im Club fand sie nicht lustig üòÇ	OTHER	OTHER
Kein NATO-Beistand bei v√∂lkerrechtswidriger Aggression der T√ºrkei Syrien 	OFFENSE	OTHER
Danke üôè 	OTHER	OTHER
bigstanagario Dazu habe ich gesagt was nicht gesendet wurde Es war kein Zufall dass der M√∂rder seinen Anschlag gg Besucher√Ønnen von Shisha-Bars richtete Diese Orte und Menschen die sich dort aufhalten wurden von konservativen Politikern und Medien zu Horten der Kriminalit√§t aufgebaut	OFFENSE	OTHER
Frost Minusgrade Wenn man Bullen und den autorit√§ren Staat im Winter angreift k√∂nnen linke Gewaltt√§ter eben nicht erwarten dass die Polizei auch noch Heizdecken verteilt le2501 Leipzig DankePolizei 	OFFENSE	OFFENSE
BlackRock oder DeutscheBank - Hauptsache Italien Gabriel 	OTHER	OFFENSE
3/3 Auch ecb k√∂nnte Staatsfinanzierung via Pandemic Bond Programme machen Staatsanleihen k√∂nnten ohne Auflagen jenseits Kapitalschl√ºssel - jedoch auf Sekund√§rmarkt - erworben werden Dies ist jedoch befristet und danach droht Hammer der Austerit√§t DEhnts	OTHER	OTHER
AfD muss Wahlkfabschluss au√üerhalb Hamburgs abhalten 	OTHER	OTHER
Gl√ºckwunsch nach Aachen an den neuen Vorstand AlternativeNRW jafuernrw 	OTHER	OTHER
Alles andere als ein Freispruch in den Scheinprozessen gegen Mesale Tolu Peter Steudtner Taner Kili√ß und all die anderen willk√ºrlich Angeklagten w√§re nach dem Ma√üstab der Rechtsstaatlichkeit ein Unding stimmeonline ChDonauer 	OFFENSE	OFFENSE
wilke_tobias GruenClaudia Der Unterschied ist dass die CDU T√§ter der Diktatur ua Goliasch eben konsequent aussortiert hat Das Heranziehen ich will sagen an den Haaren Herbeischleifen von Stanislaw Tillich ist schlicht unredlich	OFFENSE	OFFENSE
Butter bei die Fische Herr KahrsHaben Sie bei Ihrer Examensarbeitgeschummelt oder nichtüòéSatiriker Klemens Kilic Johannes Kahrs SPD-MdB hat sein Staatsexamen von jemandem anderen schreiben lassen - 	OTHER	OTHER
Von guten Ganztagsangeboten profitieren Kinder Eltern und sogar der Bund Wenn die Eltern arbeiten k√∂nnen steigen die Lohnsteuereinnahmen des Bundes Die Betreuungskosten k√∂nnte man so locker wieder reinkriegen Die tr√§gt aber die Kommune Da ist ein Ausgleich nur fair 	OTHER	OTHER
Es gibt keine totalit√§ren 	OTHER	OFFENSE
Die Kriminalisierung von Cannabis macht nun wirklich keinen SinnEin Gro√üteil aller Drogenverfahren bezieht sich auf Cannabis das nachgewiesen unsch√§dlicher ist als Alkohol Das ist eine Steuermittelverschwendung par excellenceLegalisieren und das Geld in Pr√§vention stecken	OTHER	OTHER
Mindestabst√§nde sind keine Bannmeilen Das Unweltministerium ist in der Pflicht die Vereinbarungen umzusetzen und die Blockade zu beenden - Schulze attackiert Altmaier im Streit um Abstandsregeln f√ºr Windr√§der Windkraft  	OTHER	OTHER
fpiatov Micha_DD Naja 	OTHER	OTHER
demokratienetz RenateKuenast jensspahn Habe ich Ihnen schon unter anderen Tweets erkl√§rt K√∂nnen Sie da gerne nachlesen	OTHER	OTHER
CarloMasala1 War auch kein Widerspruch	OTHER	OTHER
Mehr zum Thema gibt es hier ‚û°Ô∏è 	OTHER	OTHER
Sowas geht gar nicht Volle Solidarit√§t aus Kiel  	OTHER	OTHER
ProAsyl ninanu0 Wird mir ein Vergn√ºgen sein	OTHER	OFFENSE
Klaas_Reyms MTodtenhausen Aber das sagen wir doch  F√ºr die Umwelt aber ist es auch sch√§dlich Das sind ja Berge an Papier die unn√∂tig gedruckt werden	OTHER	OTHER
Bislang mochte ich Dich Wie Du jetzt versuchst meinen guten Ruf hier auf Twitter mit EINEM Screenshot zu diskreditieren ist schon allererste Sahne 	OFFENSE	OTHER
Klaas_Reyms Nat√ºrlich unterst√ºtzen wir keine Seite Informieren Sie sich lieber zuerst einmal was ich in aller Breite zum Thema Th√ºringen gesagt habe bevor Sie mir etwas vorwerfen Erst informieren dann diskutieren Danke	OTHER	OTHER
Lesenswert ‚òùüèª Union CDU CSU VolksparteiDerMitte 	OTHER	OTHER
Ich habe meinen Kindern immer verboten mir was zum Muttertag zu schenken oder mir zu danken 	OTHER	OTHER
dubisthallede spdde Die_Gruenen AfD ABaerbock larsklingbeil Ich denke mit Ihnen und Ihren Gesinnungsgenossen nehme ich es intellektuell jeder Zeit auf Es hat doch einen Grund dass Linke sich keiner Debatte stellen Der Grund ist ihre intellektuelle  argumentative Unterlegenheit SPD_LSA dielinkelsa GRUENE_LSA	OFFENSE	OFFENSE
Nazis raus HamburgWahl	OFFENSE	OFFENSE
Das ist mein Twitter acc vom Friesen Junge on Twitch	OTHER	OTHER
Jetzt geht‚Äôs los Die FDP ist bei Fasnacht in Franken wieder gut vertreten fif20 fdp_hessel realMartinHagen fdplgby 	OTHER	OTHER
Selbstbestimmung ist der Schl√ºssel Der eine will isoliert werden der andere angesichts langer Isolation eher ins Risiko gehen Beides ok Aber der Staat darf das nicht anordnen wirbleibenzuhause COVID„Éº19 	OTHER	OTHER
GrueneWoche Deutscher Wald braucht unsere Hilfe und IST uns eine Hilfe im Klimawandel Termin am Stand Deutscher Forstwirtschaftsrat  BrandenburgWald Land_Forst forstverein DeDFWR cducsubt CDUMV 	OTHER	OTHER
krk979 olivergorus 	OTHER	OTHER
FrauInden hubertus_heil NowaboFM Ich sch√§me mich nicht daf√ºr dass viele Menschen mit niedrigen Renten jetzt einen h√∂heren Rentenanspruch haben und haben werden anstatt Grundsicherung beantragen zu m√ºssen Klar h√§tten es mehr sein k√∂nnen wenn es nach der CDU/CSU gegangen w√§re auch keiner oder viel weniger	OTHER	OTHER
Ed99Laurin DaniLudwigMdB Der Tagesordnungspunkt wurde kurzfristig also w√§hrend der laufenden sitzung verschoben weil die Debatte zu corona davor zu lange gedauert hat und nur noch ca 35 Minuten Zeit war	OTHER	OTHER
Der kluge Michael Wolffsohn spricht die unbequeme Wahrheit aus Als ob etwa die muslimische Welt beim Judenmordennicht mit den Hitlerbanden zusammengearbeitet h√§tteSteinmeier Holocaust Israel Islam Iran ARDZDF GEZ Tagesschau Antisemiten NieWieder Shoah ZDF 	OFFENSE	OFFENSE
Christoph Matschie im Bundestag Entweder die CDU unterst√ºtzt jetzt in Th√ºringen eine Regierung Rot-Rot-Gr√ºn oder sorgt daf√ºr dass es Neuwahlen gibt Man kann nicht einen Scherbenhaufen anrichten und sich dann weigern aufzur√§umen	OTHER	OTHER
Immer wieder F√ºrth  N√ºrnberg Nach Kreide-Urteil  Papierflieger-Prozess nun Verurteilung von NoAfD-Protest obwohl sogar Polizei keine Straftat sah Das Rechtsverst√§ndnis mancher Staatsanw√§lte  Richter in Bayern ist zum Schreien 	OFFENSE	OTHER
Mit dieser l√§cherlichen weil halbherzigen Entscheidung im Fall K√ºnast macht es das Landgericht Berlin nur noch schlimmer Das darf man auch als Laie als juristischen Offenbarungseid ansehen 	OFFENSE	OTHER
ThorstenHild Es ist die Steuersch√§tzung dieser Woche  Was denn sonstUnd der Bund wird zudem dieses Jahr hoch in die Verschuldung gehen m√ºssen weil er weit h√∂here Rettungs- und Hilfsma√ünahmen ja auch prozentual leistet als die anderen Ebenen	OTHER	OTHER
Steuersenkungen gegen Corona Was hat die FDP denn da mal wieder geritten Was Deutschland wirklich braucht ist besonnenes Handeln 	OFFENSE	OFFENSE
Ein Erfolg der deutschen Diplomatie HeikoMaas erl√§utert die Ergebnisse des Berliner Prozesses 	OTHER	OTHER
demokratienetz wanderwitz Es ist mehr als absurd dass jemand wie Sie - der einen AfD-Hetz-Tweet nach dem anderen retweetet - einen Demokraten als Hetzer bezeichnet	OFFENSE	OFFENSE
Mal wieder zu Gast bei der Sportparty der StadtBacknang Beeindruckende Leistungen des Vereins-  Breitensports üëç Tolle engagierte Leute von klein bis gro√ü üòú 	OTHER	OTHER
DanyVause ü¶éü§úü§õü¶é	OTHER	OTHER
frankthethink scifi_duisburg BenjaminDThomas CDUNRW_de Es gibt linke und rechts Faschisten Demokraten sind mir lieber	OTHER	OFFENSE
Tritt Merkel wieder an 	OTHER	OFFENSE
Da bin ich doch mal im Focus Das Thema der Munitionsaltlasten in unserer Ostsee ist aber auch wirklich wichtig und mir ein Anliegen	OTHER	OTHER
KonstantinKuhle fdp harald_christ Sch√∂n dass er eine neue Heimat gefunden hat Er wird bei euch gl√ºcklicher sein ich bin mir ganz sicher ‚ò∫Ô∏èüëçüèº	OTHER	OTHER
Das war‚Äòs Ein letztes Statement zum Untersuchungsausschuss Nach √ºber 40 Zeugen war mit der Befragung von vonderleyen heute die Zielgerade erreicht Berateraff√§re 	OTHER	OTHER
Die Hinwendung zu Putin einerseits und das milit√§rische Abenteuer an der Seite terroristischer Islamisten andererseits hat innerhalb eines Monats 53 t√ºrk Soldaten das Leben gekostet Jetzt instrumentalisiert Erdogan die Fl√ºchtlinge um Geld zu erpressen	OFFENSE	OTHER
Das nenne ich konsequent von Siemens-Chef Kaeser In Australien mit dem Klimakiller Kohle Gesch√§fte machen und in Davos mit Klimafeind realDonaldTrump teuer dinieren Mit dabei VW-Chef Diess und FIFA-Chef Infantino Das nenne ich ein Gruselkabinett f√ºrs Klima Davos2020	OTHER	OTHER
DFens72703319 FLER Ihnen ist der Kf gegen radikale politische Kr√§fte und Frauenfeindlichkeit offenbar nicht so wichtig - mir schon Und ich verrate Ihnen dass heute die Bundestagsaussch√ºsse getagt haben zeitweise parallel zum Plenum etc Die Fachleute Gesundheitspolitiker waren im Plenum	OTHER	OTHER
Erschie√üen von 1% der Reichen Die Reaktion nettes Geplauder und Relativieren statt Entsetzen und klare Distanzierung Wer immer noch glaubt die Linke sei eine normale Partei sollte sich dringend genauer mit dieser Truppe befassen 	OFFENSE	OTHER
üá™üá∫üëèüèΩ Sehr gut üëèüèΩüá™üá∫ 	OTHER	OTHER
JubsyH phoenix_de Linksfraktion InesArland Die_Gruenen Ich hoffe Sie haben einen guten Anwalt √úberweisungstr√§ger schon mal ausf√ºllen Das wird teuer	OFFENSE	OTHER
matthimon bak_shalom katjakipping KatharinaKoenig Nein ich m√∂chte nicht antworten Diese Mackeransprache gegen√ºber Frauen sie w√ºrden Texte zumal juristische nicht verstehen selbst wenn sie diese selbst verfasst haben kannste Dir sonstwo hin stecken	OFFENSE	OFFENSE
SDullien PeterBofinger AchimTruger tom_krebs_ Thank you Investment enables ex post savings also helpful to debunk savings glut argument	OTHER	OTHER
Ich halte zu dir Karamba Bleib wie du bist Du bist ein aufrechter Mensch und SozialdemokratSPD zusammenhalt Nach Sch√ºssen auf Abgeordnetenb√ºro SPD-Politiker Diaby erh√§lt Morddrohung 	OTHER	OTHER
ESC2020 Gl√ºckwunsch Litauen Ohrwurm Ikone Performance Extraportion Queerness Alles was ESC-Klassiker braucht üá±üáπ	OTHER	OTHER
Gnadenerlass von Herrn Roman zum Muttertag  Entweder darf man virologisch begr√ºndet die Mutter sehen oder nicht In welchem Land leben wir denn wenn der Chef der Bundespolizei solche Willk√ºr mit Blick auf ein Grundrecht walten lassen kann  Europa	OFFENSE	OTHER
aktuelle_stunde JoachimSt Das bekannte Freud-Zitat √ºber Schamlosigkeit und Schwachsinn soll wohl nicht authentisch sein	OFFENSE	OFFENSE
jessenphil Der Typ kopiert Dich	OTHER	OFFENSE
RobertEckelmann das sind 2 paar schuhe	OTHER	OTHER
Was genau liebe DB_Bahn verbirgt sich hinter versp√§tete Bereitstellung   Frage nur aus Neugier die meisten Reisenden sind heiter im ICE 1003 auf dem Weg nach Halle/Erfurt/M√ºnchen ohne Stau 	OTHER	OTHER
maternus Elitenerlass Grundgesetz Artikel 3 3	OTHER	OTHER
Klar Wenn man den Ostdeutschen nur besser erkl√§rt h√§tte warum ihre Biografien massenhaft entwertet ihr bisheriges Leben oft einfach in die Tonne gekloppt und viele ihrer Rentenanspr√ºche nicht anerkannt wurden w√§re heute alles viel besser Endlich sagt es mal einer ü§¶‚Äç‚ôÇÔ∏èü§¶‚Äç‚ôÇÔ∏èü§¶‚Äç‚ôÇÔ∏è 	OFFENSE	OFFENSE
DerMoellmann CSU Markus_Soeder P TB	OTHER	OTHER
Diese SPD hat fertig V√∂llig fertig Und je schneller sie untergeht desto besser f√ºr unser Land 	OFFENSE	OTHER
Otto_Fricke MuHart KonstantinKuhle Ich w√ºrde mich gerne an den Reinigungskosten beteiligen Obwohl ich die 3 Buchstaben von Otto_Fricke vollinhaltlich unterschreibe Bitte Bankverbindung an mein B√ºro schicken KonstantinKuhle	OTHER	OTHER
Hass ist keine Meinung Am Weltfrauentag das Netz von Antifeminismus befreien NetzohneFrauenhass 	OTHER	OFFENSE
Nur die Linkspartei lobte den FDP-Au√üenminister -RichtigTragisch dass die Bellizisten von damals nichts hinzugelernt zu haben scheinen angesichts des immer fortw√§hrenden Regime-Change-Get√∂ses  den Rufen nach einem neuen Milit√§reinsatz in Libyen 	OTHER	OTHER
c_jung77 H√§ttest Du Dir die Pressekonferenz angesehen w√§re Dir die Entschuldigung nicht entgangen	OTHER	OTHER
Die Fraktion der Taeterpartei radikalisiert sich t√§glich mehrDeutschland hat ein Sozialismusproblem das immer klarer zutage tritt 	OFFENSE	OTHER
Demokratie im Wandel Eine Diskussionsveranstaltung so wichtig wie nie Th√ºringen fordert ein Umdenken Links ist eben nicht demokratiefeindlich wie die Faschisten der AFD Wir wollen ein anderes Wirtschaftssystem Das ist auch mit dem Grundgesetz erlaubt und m√∂glichDieLinke 	OFFENSE	OFFENSE
Wir lassen uns von unseren Regierungen nicht unser Leben kaputt machen Wir wollen dass wer an Afrika denkt nicht l√§nger die Bilder von Krieg und Hunger im Kopf hat RLS_dakar 	OFFENSE	OTHER
Brutus mit dem Dolch im Gewande 	OFFENSE	OFFENSE
Es ist gut dass auch die G√∂ttinger Polizei dieses Thema im Rahmen bundesweit abgestimmter Aktionen auf dem Schirm hat Umso √§rgerlicher ist es dass bei der Durchsuchung gegen die Gruppe Aryan Circle Germany ein solcher Fehler passiert	OTHER	OTHER
Richtig Charlie Unter hubertus_heil schaut die BMAS_Bund nach einem am Gemeinwohl orientierten Einsatz von KI w√§hrend unser spdde Sozialstaatskonzept der solidarischen Kultur des Miteinanders neues Leben einhaucht sozialstaatalspartner Solidarit√§t 	OTHER	OTHER
Die SPD h√§lt in der GroKo in Treue fest zu ihrer sozialdemokratischen Erf√ºllungsgehilfin mit schwarzem Parteibuch Diese unheilige Allianz gegen üá©üá™ muss endlich beendet werden 	OFFENSE	OTHER
Krass ist das √ºbel dass die Linke Hamburg ein rechtsextremes U-Boot der Identit√§ren auf ihrer Liste hat HamburgWahl	OFFENSE	OFFENSE
Ausgabe von Hilfs-Schecks in den USA verz√∂gert sich weil Trump fordert dass sein Name draufgeschrieben wirdWenn Egozentrik und Wahlkf wichtige finanzielle Hilfe f√ºr Menschen verhindertRechtspopulisten dieser Welt sind eine Gefahr f√ºr Leben und Existenz von Menschen	OFFENSE	OTHER
n_roettgen Wahnsinn Mit dieser Regierung wird sich 2015 wiederholen	OFFENSE	OTHER
Wenn der Faschist H√∂cke bei der morgigen MPWahl in Th√ºringen antritt soll die CDU laut Kuban vor die T√ºr gehen Sieht so der Einsatz der CDU f√ºr Demokratie und gegen Faschismus aus Den Platz r√§umen anstatt dagegen zu halten	OFFENSE	OTHER
CarloMasala1 	OTHER	OTHER
Der AfD-Chef beklagt die Verrohung der politischen Debatte Ach Gottchen bis zum 1 April ist es noch etwas hin 	OFFENSE	OFFENSE
Bewegende Rede von DjirSarai im Bundestag √ºber allt√§glichen Rassismus in Deutschland Als B√ºrger dieses Landes sage ich Rassismus darf bei uns keinen Platz haben Hanau Rechtsterrorismus	OTHER	OTHER
F√ºr Frieden Gerechtigkeit und Klima - wie kann sich Europa in einer Welt der internationalen Konflikte Machtk√§mpfe und Handelskriege behaupten Freue mich auf die Diskussion heute Abend in Indelfingen 	OTHER	OTHER
Eine neue Folge meines Podcast Politik mit Links mit den Themen Klare Kante gegen Faschisten siehe Th√ºringen Was hat CDU-Merz mit Rot-Rot-Gr√ºn zu tun und wie l√§uft es f√ºr Bernie2020  H√∂rt rein	OTHER	OFFENSE
Diesen Thread m√ºsst Ihr bis zum Ende lesen Aber seid gewarnt die Lekt√ºre k√∂nnte Euch verunsichern ‚¨áÔ∏è 	OTHER	OTHER
Und deswegen habe ich im Bundestag immer gegen die KandidatInnen der NoAfD f√ºr das Amt des/der Vizepr√§sidentIn gestimmt und habe kein Verst√§ndnis daf√ºr wenn andere im Bundestag oder Landtagen daf√ºr stimmen	OFFENSE	OTHER
N√§chste Klatsche f√ºr Verkehrsminister Scheuer vor Gericht Das OVG hat entschieden dass Journalisten beantworten muss warum er wegen des Diesel-Betrugs keine Bu√ügelder 20 Milliarden Euro verh√§ngte wie es im Gesetz steht Dealte er mit den Auto-Bossen	OFFENSE	OTHER
Das gesamte Ma√ünahmenpapier von aminajxx berivan_aymaz BelitOnay und mir findet ihr hier 	OTHER	OTHER
dimetrodon109 MelAmann Einzige Ausnahme diesmal statt des ewigen Habeck darf heute einmal gn√§digerweise die gr√∂√üte Oppositionsfraktion teilnehmen Also AliceWeidel gegen 5 	OFFENSE	OFFENSE
Anahmana11 Und Du bist gar nicht bei Twitter üòÇ	OTHER	OTHER
Deswegen haben wir im Bundestag Verbesserungen beschlossen H√∂heres Kurzarbeitergeld mehr Zuverdienst und l√§ngeres Arbeitslosengeld	OTHER	OTHER
Bin gespannt wie lange diese knallharte Ansage gilt Ob das schon Mutti wei√üüòâumfaller fdp 	OFFENSE	OFFENSE
gehirn1974 ArgumentAriadne Nachdenken reflektieren und die Erkenntnisse festhalten ist Teil der politischen Arbeit Au√üerdem bekomme ich kein Honorar f√ºr diese Flugschrift	OTHER	OFFENSE
Wenn wir die Zukunft in unserem Land gemeinsam gestalten wollen m√ºssen wir rechtsextreme Netzwerke bis in die kleinste Struktur  austrocknen - online wie offline Aber daf√ºr reicht ein einzelnes Verbot nicht ausUnser Ma√ünahmenpaket gg Rechtsextremismus	OTHER	OTHER
Italien zockt bei EU-Hilfen EuroBonds sind abzulehnen auch wenn sie pl√∂tzlich CoronaBonds hei√üen sollen	OTHER	OTHER
NurEinRealist Sie sind ja ein richtiger Blitzmerker	OFFENSE	OTHER
dgb_news Anja_Piel Allerbeste Gl√ºckw√ºnsche liebe Anja_Piel üíö - freu mich auf die Zusammenarbeit mit dir Feminismus Vielfalt Diversit√§t	OTHER	OTHER
peter_simone 	OTHER	OTHER
++Achtung++Bitte++Teilen  Zeichen++Helfen Sie unsere Familien Eltern  Kinder vor der Zerst√∂rung durch die Ideologie von dieLinkeDie_Gruenen  spdbt zu bewahren Lesen Sie bitte die Pressemitteilung und zeichnen Sie die Petition AfDimBundestag 	OFFENSE	OTHER
Angeblich in Berlindirekt am Sonntag mal schauen wie sie‚Äôs schneidenüòâAfD Berlin Brandner Bundestag Staatsfunk 	OTHER	OTHER
B√ºrgerabend mit Mary Khan-Hohloch und mir in Thueringen Schmalkalden Kommen Sie vorbei und fragen Sie uns was Sie immer schon √ºber die AfD Frauen und den Islam wissen wollten P√ºnktlich zum Frauentag am 8M√§rz Wahlkreis196 AfD_SThueringen Mary_Khan94 JA_Deutschland 	OTHER	OTHER
stephan_balling uebergabe AndrHM3 Die_Gruenen marburger_bund BMG_Bund Wir werden eine andere Zusammenarbeit der Gesundheitsberufe brauchen wenn wir die n√§chsten 40 Jahre unser Gesundheitswesen erhalten wollen Wer soll denn die Schnittstellen fachlich definieren wenn nicht demokratisch legitimierte berufsst√§ndische Organisationen wie Kammern	OTHER	OTHER
Duisburg hat seit heute ein Autokino üé•üöò Heimat Kino Autokino 	OTHER	OTHER
Beim SEK NRW verschwundene Munition landete bei Polizisten in Mecklenburg-Vorpommern die Teil von Strukturen unter Rechtsterror-Verdacht sind Keine falschen H√§nde sondern bundesweit aktive rechte/rechtsterroristische Netzwerke Nordkreuz Uniter 	OTHER	OTHER
Alles geben f√ºr fegebanks in Hamburg 	OTHER	OTHER
Havergoe Der franz√∂sische Pr√§sident hat die NATO gerade als hirntod bezeichnet Helmut Schmidt wollte ihre Aufl√∂sung zu Gunsten gesamteurop√§isch Sicherheitsarchitektur und wir fordern dies mittelfristig auch bei Austritt aus milit√§rischen Struktur Koa-Hindernis war das √ºbrigens nie	OTHER	OTHER
Von den 948000 Menschen die verzweifelt durch die Region Idlib irren sind 560000 Kinder Es braucht einen humanit√§ren Korridor - Jetzt 	OTHER	OTHER
Das Einwanderungsgesetz tritt in Kraft Es geht um  Fachkr√§ftebedarf Und es geht um Regeln zur Einwanderung die legale Migration erm√∂glichen Aktuelle Entwicklungen machen uns Sorgen gleichzeitig zeigen wir wie wir besser steuern und ordnen k√∂nnen 	OTHER	OTHER
Geht gar nicht Aus dem Urteil Insbesondere die Menschenw√ºrde ist ohne R√ºcksicht auf Eigenschaften und sozialen Status wie auch ohne R√ºcksicht auf Leistungen garantiert sie muss nicht erarbeitet werden sondern steht jedem Menschen aus sich heraus zu 	OTHER	OTHER
Freu mich drauf Dann bis Samstag in Erfurt bei Nichtmituns Unteilbar 	OTHER	OTHER
SsamanMardi immer ü•≥	OTHER	OTHER
VenusTaurica ohoerl Die Frau und das Kind befanden sich vor dem Haus nicht im Haus Vor dem Haus wurden sie beschossen Daraufhin sind sie geflohen TB	OTHER	OTHER
Es werden Panzer und Bomben f√ºr einen Krieg vorgehalten Ja man probt den Krieg sogar und liefert anderen daf√ºr Waffen Aber es gibt offenbar nicht genug Schutzausr√ºstungen f√ºr medizinisches Personal bei einer Pandemie Das ist doch Irre coronavirus	OTHER	OTHER
Herzlichen Gl√ºckwunsch an alle 	OTHER	OTHER
Hierzu berichtet auch die New York TimesEU Officials Push for Bloc to Enforce Libya Arms Embargo	OTHER	OTHER
SteffenSchwalm heronie__ Lenin war Vorsitzender der kommunistischen Bolschewisten und verantwortlich f√ºr Staatsterror und Menschenrechtsverletzungen im Zuge der Oktoberrevolution 1917 in Russland Er steht f√ºr Massenmord und Totalitarismus Dass Sie das als Quatsch bezeichnen gibt uns sehr zu Denken TB	OFFENSE	OFFENSE
_FriedrichMerz Bek√§mpfung von Linksextremismus trauen Sie sich nicht W√ºrde das zuk√ºnftige Koalitionspartner verschreckenIn dieser CDU ist l√§ngst kein Platz mehr f√ºr Konservative Merz Laschet oder R√∂ttgen V√∂llig egal Die CDU geht den Weg der spd Abw√§rts immer aufw√§rts nimmer	OTHER	OTHER
c_lindner KemmerichThL Es w√ºrde mich wundern wenn Sie am Ende des Jahres noch Chef der FDP sind Herr LindnerüòéRamelow Thueringenwahl AfD Hoecke MPWahl Kemmerich SED	OFFENSE	OFFENSE
Zusammenstehen also einer vorne alleine und die anderen unfreiwillig dahinter sozusagen CDUVorsitz _FriedrichMerz ArminLaschet jensspahn n_roettgen CDU Merz Laschet Spahn Roettgen 	OTHER	OTHER
Die CDU ist doch nicht mehr CDU sondern SED mit der Staatsratsvorsitzenden Merkel 	OFFENSE	OFFENSE
Martin_Debes ü§¶üèº‚Äç‚ôÇÔ∏è	OTHER	OTHER
Das Mehrgenerationenhaus Arnsberg hat sich f√ºr den Titel des DemografieGestalters 2020 beworben und steht in der engeren Auswahl Richtig gut Jetzt mitmachen und f√ºr‚Äôs MGH Arnsberg stimmen Hier geht‚Äòs zur Abstimmung 	OTHER	OTHER
JETZT WIRD‚ÄôS RICHTIG GR√úN - heute starten ‚Å¶bielefeldgruen‚Å© mit ihrem Neujahrsempfang ins Kommunalwahljahr 2020 NRW 	OTHER	OFFENSE
Es werde nicht laufen wie 2015 sagt armin_schuster im Interview mit dem ardmoma Wir werden das nicht wieder alleine l√∂sen  Wir wollen gemeinsam betriebene Fl√ºchtlingszentren die an den Grenzen Asyl-Vorentscheidungen treffen üì∫	OTHER	OTHER
Achso DAS ist die richtige demokratische Wahl Das Ergebniss wird im Vornherein festgelegt danach wird ein Los gezogen damit das Ergebniss dann auch passt Waren die alle bei der SED oder was Und dann sagt man die AfD hat die parl Demokratie missbraucht ü§™ Thueringen TS 	OFFENSE	OTHER
Porkchop_EXP jensspahn That Is a Point too	OTHER	OTHER
Basta  Ein Gro√üteil meiner ital Familie lebt in Cania B√ºffelmozzarelle sind ein Traum aber Mafia ist ein Krebsgeschw√ºr Roberto Saviano hat den Zusammenhang zwischen Privatisierung Giftm√ºll und Mafia in Gomorrha geschildert Ein Land wird vergiftet 	OFFENSE	OFFENSE
lederwalze Wenn der angerichtete Schadendurch den Lockdown sichtbar wirdglaube ich nicht  dass Sie weiter sowirres Zeug faseln	OFFENSE	OFFENSE
Politischer Fastendonnerstag unserer CDU Karlsruhe-Land in Karlsdorf-Neuthard mit PaulZiemiak Klare Kante unseres Generalsekret√§rs der CDU in schwierigen Zeiten 	OTHER	OTHER
Elmar Brok bezeichnet Werte-Union als Krebsgeschw√ºrKrebs ist eine Krankheit deren Ausrottung wir alle wollenWollen Sie Herr Brok diese Menschen ausrottenIst Ihnen klar dass Sie die Sprache der Unmenschen sprechen CDU WU 	OFFENSE	OFFENSE
sara_linho TillRaether Als Studentin hab ich oft die Dosen Chignons 3 Wahl gekauft kosteten fast nix bestanden aus lauter braunen Stellen aber es waren Pilze üòã u andere waren zu teuer Die gibt es schon sehr lange gar nicht mehr	OTHER	OTHER
matze2001 mueste300 friiyo SZ Der faktenfinder widerlegt gar nix sondern √ºbernimmt einfach die Deutung neoliberaler Gesundheitswissenschaftler Es geht um politische Interpretation und nicht um falsche Fakten	OTHER	OTHER
Ex-Banker von US-Investment-Bank MerrillLynch packt √ºber Steuerraub CumEx ausHeute 2145 Uhr  bei  ARDPanorama AnjaReschke1 OliverSchroem CSalewski oder in der Mediathek üëâ	OTHER	OTHER
In Zeiten des Rechtsrucks w√§re ein Kanzler oder CDUVorsitz Friedrich Merz verheerendes Signal Steht nicht nur f√ºr Steuersenkungen von Reiche K√ºrzungen der Renten Politik im Sinne von Blackrock sondern auch Normalisierung der noafd Klare Kante statt Nazi-Kuscheln ‚úä linke 	OFFENSE	OFFENSE
So Zwischenstopp f√ºr heute wobei es nachdenklichü§î stimmt wenn man bei BurgerKing einen der dortigen Mitarbeiter vom üöΩ kommen sieht der sich nicht die H√§ndeü§≤ w√§schtüò≥ dann kurz mit Eimer und Schrubber hantiert um danach im K√ºchenbereich zu verschwindenü§¢ 	OTHER	OTHER
Gl√ºckw√ºnsche gehen nach Leipzig Burkhard_Jung bleibt OB  Leipzig bleibt sozialdemokratisch ‚úä obmle20 SPDSachsen	OTHER	OTHER
Deine Werbung hat verfangen so k√∂nnte man sagen üí™üèºüëèüèºüëèüèº 	OTHER	OTHER
Frau dunjahayali wieviele Menschen gerade im Osten kennen Sie Welche Erfahrung haben Sie mit den Verh√§ltnissen in SachsenAnhalt Sie sprechen genau aus jenem besagten Elfenbeinturm Sie sind eine voreingenommene Gesinnungsjournalistin des politisch-medialen Establishments 	OFFENSE	OTHER
GoersHennes BdB_Deutschland Ich wei√ü üôè Wir hatten erst Ende letzten Jahres eine sehr gro√üe Konferenz im Bundestag zur UNBRK die meine Kollegin crueffer organisiert hat	OTHER	OTHER
Die AfD ist raus aus der B√ºrgerschaft Danke Hamburg Das ist ein wichtiges Signal der Absage an Hass rechtsradikaler Hetze und geistiger Brandstiftung und zudem ein verdientes Ergebnis f√ºr die Verachtung des Parlamentarismus durch diese Partei	OFFENSE	OTHER
Wer sind eigentlich die Paten von Scharpings vergessenen Kindern insider 	OTHER	OTHER
Ein Niedersachse vererbt sein gesamtes Verm√∂gen √ºber 7 Mio Euro der AfD - eine der gr√∂√üten Geldzufl√ºsse f√ºr eine Partei Ein verdammt schlechtes Investment f√ºr die Gesellschaft aber es zeigt mal wieder auf dass sich Kapital  Faschismus in st√§ndigem Flirt befinden	OFFENSE	OFFENSE
ARD_BaB akk larsklingbeil Was war in Th√ºringen Unfall In der CDU macht jeder was will das ist doch das Problem von AKK	OFFENSE	OTHER
Auweia üò¨ü§¶‚Äç‚ôÇÔ∏è 	OFFENSE	OTHER
JUNG Solange zweifelhafte Abgrenzung nach Verkaufsfl√§che in BW gilt muss die Regelung durch die LReg in S flexibel gehandhabt werden Besonders f√ºr Region Karlsruhe u nordbadischen Raum ist dies wegen N√§he zu Rheinland-Pfalz wichtig 	OTHER	OTHER
Jetzt also die 2 Staffel von Politiker sucht Frau jetzt von der CDU - peinlich und unw√ºrdig 	OFFENSE	OTHER
rosisternberg KlaasTamme spdbt peteraltmaier Richtig bei Missachtung der Belegausgabepflicht gibt es kein Bu√ügeld Viele Gr√º√üe vom Team Binding	OTHER	OTHER
In der Landeserstaufnahmeeinrichtung in Ellwangen hat sich die Zahl der Corona-Infizierten rasant von 7 auf 251 erh√∂ht eine Erkl√§rung seitens des Regierungspr√§sidiums steht noch aus DieLinke_MA dieLinke 	OTHER	OTHER
MedusSedum Die_Linke CDUBerlin_AGH stefanruehle In ihrer Logik w√§re jede Steuererhebung bereits Unrecht und DDR Und wenn man keine Ahnung von g√§ngiger Grundrechtsdogmatik hat jeder CDU Jurist wird ihnen best√§tigen das Grundrechte Schranken haben genau wie jeder 1 Semester Jurastudent sollte man sich etwas zur√ºckhalten	OFFENSE	OTHER
Grundrechte zur√ºckfordern ‚Äì Demo in SindelfingenAm morgigen 16 Mai spreche ich auf der vom AfD-Kreisverband B√∂blingen angemeldeten Demonstration in Sindelfingen Wir demonstrieren ab 1400 Uhr auf dem Parkplatz Sportwelt/Glaspalast in der Rudolf-Harbig-Stra√üe Corona 	OTHER	OTHER
Recht hat er der kahrs 	OTHER	OTHER
Neben der Erh√∂hung des Steuerfreibetrages werbe ich f√ºr eine Mehrheit im Bundestag f√ºr die Verschiebung des Spitzensteuersatzes zur Entlastung der Mittelschicht 18 Millionen Arbeitnehmer m√ºssen raus aus der Spitzenbesteuerung Finanzieren sollen es wirkliche Topverdiener 	OTHER	OTHER
Quaelgott fdp Ich bin v√∂llig anderer Meinung AfD folgt Ideal einer v√∂lkische definierten und m√∂glichst homogenen Gesellschaft im nationalstaatlichen Geh√§use Die FDP steht f√ºr Individuum in Gesellschaft der Vielfalt und weltoffenen Staat der sich f√ºr Kooperation und Welthandel einsetzt	OTHER	OTHER
BMWi_Bund MKreutzfeldt news_rapha bmu peteraltmaier Was werden Sie tun peteraltmaierGeb√§udesektor wird laut Prognose in 2030 √ºber 24% MEHR CO2 emittieren als BuReg-SektorzielSie m√ºssen daf√ºr sorgen dass Geb√§ude die heute gebaut werden klimaneutral sindAlles andere ist volkswirtschaftlich UnsinnGeb√§udeenergiegesetz	OTHER	OTHER
Los geht‚Äôs Leipzig Ran an der Wahlurnen Damit Leipzig sich weiter pr√§chtig entwickelt und so vielf√§ltig charmant bleibt heute Burkhard_Jung w√§hlen	OTHER	OTHER
Nicht nur √ºberheblich und peinlich sondern es offenbart auch wirtschaftspolitische Ahnungslosigkeit der SPD-Vorsitzenden Hoffentlich beh√§lt wenigstens der Finanzminister seinen KompassSteuersch√§tzung Grundrente Wirtschaft esken eskengate BILD 	OTHER	OTHER
Strategiekonferenz dieLinke  Wir brauchen ein breites antifaschistisches B√ºndnis und GLEICHZEITIG m√ºssen wir die Politik des Sozialabbaus von CDU SPD Gr√ºnen und FDP scharf angreifen Denn die Angst vor sozialem Abstieg ist der N√§hrboden des Faschismus linkestrategie 	OTHER	OFFENSE
Freizeitgraf FlorianPost dezentralrat Die jungen Leute die gegen Uploadfilter demonstriert haben wurden auch als Botsbeschimpft Erb√§rmlich Die Passwortherausgabe ist schlicht ein Angriff auf die B√ºrgerrechte Aber so kennen wir die GroKo immer im Kf gegen das freie Netz 	OFFENSE	OTHER
hahnflo starke Rede in Bundestag Doppelmoral der Linken entlarvt	OFFENSE	OFFENSE
danielmack dieLinke Und dann	OTHER	OFFENSE
abschlusse Ja werde ich machen üòâ	OTHER	OTHER
MAStrackZi CarloMasala1 fritzfelgentreu MunSecConf Wer zahlt Au√üerdem wollten wir eh mal in Ruhe einen Rotwein trinken - Ok ich sagte in Ruhe	OTHER	OTHER
MalteOppermann AliKaanSevinc NowaboFM EskenSaskia soziluca Servicekoalitionspartner üòâ	OTHER	OTHER
Bildungsministerin AnjaKarliczek l√§uft Gefahr als Ank√ºndigungsministerin und Umsetzungsversagerin in die Geschichte einzugehen Ich sage immer Ran an den Speck Frau Karliczek Bald muss ich sagen Der Speck ist weg Frau Karliczek 	OFFENSE	OTHER
Es gibt manchmal tats√§chlich noch √Ñu√üerungen aus der cdu die den Eindruck vermitteln da√ü es dort Reste von demokratischem Denken gibt Die Botschaft h√∂re ich wohl Allein mir fehlt der Glaube Zumal in der cdulsa die merkeltreuen Betonk√∂pfe leider NOCH tonangebend sind 	OFFENSE	OTHER
Mit ‚Å¶m_kormbaki‚Å© habe ich ua  √ºber Au√üenpolitik in Corona-Zeiten europ√§ische Solidarit√§t und die Bedeutung der ‚Å¶WHO ‚Å© gesprochen ‚Å¶AuswaertigesAmt‚Å© ‚Å¶RND_de‚Å©  	OTHER	OTHER
Besch√§ftigte in Niedriglohn-Bereichen m√ºssen von ihrem Kurzarbeitergeld leben k√∂nnen Deshalb sollten die geltenden gesetzlichen und tariflichen Mindestl√∂hne als Untergrenze f√ºr die Zahlung von Kurzarbeitergeld gelten CoronaVirusDE CoronaVirusDE 	OTHER	OTHER
Innerorts um 21 km/h und au√üerorts 26 km/h schneller fahren als erlaubt passiert nicht einfach so Wer rast gef√§hrdet andere Verkehrsteilnehmer Wer aufmerksam unterwegs ist und sich an die Regeln h√§lt mu√ü kein Fahrverbot f√ºrchten StVO 	OTHER	OTHER
Die Einschr√§nkung des gesellschaftlichen Lebens durch die Absage von Gro√üveranstaltungen ist zwar ein markanter Schritt aber jedenfalls wirksamer als Grenzkontrollen und daher spreche ich mich an dieser Stelle daf√ºr aus sagte Achim Kessler  	OTHER	OTHER
Saukopfessen der Feuerwehr im Landkreis Karlsruhe Axel_Fischer olavgutting 	OTHER	OFFENSE
Der Gesetzgeber kann nicht einmal Hetze richtig definieren Facebook liefert aber wie bestellt Meinungsfreiheit wird unter dem Gef√ºhl Hass blockiert Sch√∂ne neue Welt 	OFFENSE	OTHER
Menschlichkeit statt M√§nnlichkeit	OFFENSE	OFFENSE
Das ist keine √úberraschungCDU  er war ja bisher schon die graue Eminenz Mal sehn wie gro√ü das Machtvakuum von AKK ist und wer jetzt noch schnell den Hut in den Ring wirft Die Spiele haben begonnen 	OTHER	OFFENSE
+++ Framing und Propaganda in Reinform - die Gr√ºnen und der Energiegipfel +++Auf dem Energiegipfel wird die 	OFFENSE	OFFENSE
Wir haben dort in Lesbos in One Happy Family Musikunterricht f√ºr Fl√ºchtlinge organisiert es war eine Oase f√ºr alle Das ist eine Katastrophe mit Ansage Die EU hat die Insel mit den Fl√ºchtlingen alleine gelassen Holt endlich die Fl√ºchtlinge aus Moria in die EU auch hierher 	OFFENSE	OTHER
Da die gesamte EU allerdings den Klimanotstand ausgerufen hat k√∂nnen wir leider auch nicht helfen 	OTHER	OTHER
Ein paar coole Leute haben meine parlamentarische Arbeit zur Abzocke an den Autobahnrastst√§tten Tank  Rast / Sanifair genutzt f√ºr ein exzellentes Aufkl√§rungs- und Zerst√∂rungsvideo Gegen Privatisierung und gegen Verkehrsminister Scheuer Anschauen 	OTHER	OTHER
Segeltexter Schade	OTHER	OTHER
Degrad21 PhilHackemann larsklingbeil Ich kenne viele aufrechte Antirassisten in der FDP die sich klar gegen Nazis positionieren Die m√ºssen halt mal lauter werden Etwa auch wegen solchen Vorkommnissen wie einer gemeinsamen Fraktion auf Gemeindeebene mit der AfD 	OTHER	OFFENSE
ErikMarquardt Das Kompliment gebe ich gerne zur√ºck	OTHER	OTHER
Das kann nur ein schlechter Witz sein Draghi steht exemplarisch f√ºr die Enteignung deutscher Sparer und den Aufkauf von Schrott-Anleihen hochverschuldeter Staaten durch die EZB Daf√ºr gibt es das Bundesverdienstkreuz obendraufAfDimBundestag AfD 	OFFENSE	OTHER
Aus dem Artikel 70% von 83 Mill Menschen w√§ren n√∂tig um Herdenimmunit√§t zu erreichen 58 Millionen die sich infizieren m√ºssten Wenn davon jene 037% sterben w√ºrden von denen Streeck spricht dann w√§ren das 215000 Menschen Das entspr√§che der Einwzahl von Mainz oder Erfurt	OTHER	OTHER
JorgWolfrum kommentator annewill Stk_Brandenburg verstehbahnhof juergengeck Unsere Visier-Kopfteile sind inzwischenauch Spritzguss sonst k√§men wir nie auf 12000 St√ºck u wir verwenden richtige Visierfolie durch die man hervorragend gucken kann üòÅ Es ist gut dass es langsam mehr Angebote gibt der Bedarf ist sehr gro√ü	OTHER	OTHER
Die l√§ngste erfolgsbilanz  War eine tolle Aktion heute Hat Spa√ü gemacht spd m√ºnchen dieterreiter  Munich Germany 	OTHER	OTHER
NATO darf illegalen Krieg der T√ºrkei keinesfalls unterst√ºtzen sondern muss Erdogan zur Deeskalation aufrufen Er f√ºhrt Krieg nicht f√ºr EU oder syrische Bev√∂lkerung sondern nur f√ºr sich selbst  seine Gro√ümachtphantasien	OTHER	OTHER
Das sagt schon was √ºber F√ºhrungs- und Verantwortungsbewusstsein von Frauen  M√§nnern im Vergleich Lindner AKK Merkel Nahles	OTHER	OFFENSE
Tja die Mitte ist eben nicht da wo die CDU sie verortet‚ò∫Ô∏è 	OTHER	OTHER
Habecks Attacken auf Trump sind flegelhaft  zeugen von schlechtem Benehmen Wer hohe Staats√§mter anstrebt  au√üenpolitisch etwas erreichen will muss hart in der Sache aber in angemessenem Ton argumentieren CSU ASPderCSU csu_bt cducsubt	OFFENSE	OTHER
LindaTeuteberg In der Tat geht Bollwerk der Demokratie anders liebe FDP Etwa indem man sich nicht von Faschisten zum Ministerpr√§sidenten w√§hlen l√§sst oder Antr√§gen der AfD zustimmt	OTHER	OFFENSE
DFoest fdpbt starkwatzinger OlliLuksic Danke üòä	OTHER	OTHER
janboehm CDU üëáüèªüëáüèª 	OTHER	OTHER
Noroscam ü§¶üèª‚Äç‚ôÇÔ∏è	OTHER	OTHER
Der Verfassungsschutz hat die Verfassung zu sch√ºtzen und nicht die Regierung und die sie tragenden Parteien ‚Äì auch wenn diese glauben nur noch mit unfairen Methoden die b√ºrgerliche Oppositionspartei AfD kleinhalten zu k√∂nnen 	OTHER	OTHER
Wer behauptet mit ArminLaschet und jensspahn w√ºrde es nur weiterso geben kennt beide nicht und hat ihnen wohl auch nicht zugeh√∂rt Ein erfolgreicher MP Laschet und ein erfolgreicher Bundesminister Spahn stehen f√ºr Aufbruch TeamZukunft und klares CDU-Profil CDUVorsitz	OTHER	OTHER
Nat√ºrlich auch im Zug auf dem Weg nach Berlin mit mundnasenbedeckung - diesmal mit der gestern Abend frisch von mir erstellten 	OTHER	OTHER
Gl√ºcksspiel im Internet wird also legal Geldgier siegt √ºber Moral Freiheit die ich meineerb√§rmlich	OFFENSE	OTHER
Immer h√§ufiger wird im Meinungsstreit Gewalt angedroht oder gar ausge√ºbt Wir d√ºrfen nicht zulassen dass sich hier ein Klima aus Hass und Angst breit macht Ob gegen Politik Medien Staat ob gegen Minderheiten oder Andersdenkende - gewaltt√§tiger Hass muss bestraft werden 	OTHER	OFFENSE
JmBln Doppelgeist60 Ralf_Stegner Ich bin ja noch nicht einmal 60 Jahre alt Nach amerikanischem Muster habe noch mindestens zehn Jahre Zeit um Karriere zu machen üòé	OTHER	OTHER
Am Erinnerungsort Zizernakaberd Gedenken an die Opfer der Gr√§ueltaten an den Armeniern 1915/16 im Osmanischen Reich Ihr Leid wird nicht vergessen werden  üá™üá∫üá©üá™üá¶üá≤ MFAofArmenia AuswaertigesAmt GERonOstpolitik 	OTHER	OTHER
tagesschau Haben Sie denn schon einen Finanzpolitiker gefunden der das Bargeld abschaffen will Ich kenne keinen einzigen der das will - in keiner Partei	OTHER	OTHER
Linke Antidemokraten blockieren AfDFraktionLSA Veranstaltung in Salzwedel Stehe seit einigen Minuten  warte dass mich die Polizei durch die von Linken Gr√ºnen  SPD hofierten gewaltbereiten Teile der Zivilgesellschaft f√ºhrt Ich komme durch da gibt es kein Vertun F√ºrüá©üá™üëç 	OTHER	OFFENSE
LFAWV truedockorn üòåüòåGenau deshalb muss dieser Bl√∂dsinn doch endlich beendet werden Jeder H√§ndler der eine sichere Kasse hat kann die Bonpflicht sofort abschaffen - so unsere Forderung TB	OFFENSE	OFFENSE
In Berlin beraten Altparteien und Lobbyisten √ºber den Kohleausstieg derweil bangen zehntausende Menschen in der Lausitz um ihren Job Ausl√∂ser die allgemeine Klimahysterie Fr√ºher oder sp√§ter wird die AfDimBundestag dieses Klima-Unsinn-Paket kippen 	OFFENSE	OTHER
hddoger Nein üòÑ	OTHER	OTHER
matthimon bak_shalom katjakipping KatharinaKoenig Das ist so infam dass es schwer f√§llt ernsthaft zu antworten Aber irgendjemand muss es ja tun in Zeiten wo Provokation offenbar mehr gilt als Politik Also hier sind Argumente aus der LINKEN und der Linken 	OTHER	OTHER
Linksextremistmus AfD-Bundeschef Chrupalla bei Feueranschlag verletzt 	OTHER	OTHER
Der gestrige Auftritt von AndiScheuer bei Markus__Lanz hat mich mehr schockiert als am√ºsiert Die Aufkl√§rung des Maut-Desasters im Untersuchungsausschuss ist notwendiger denn je und keine gr√ºn-gelbe Herzkagne CJ fdpbt maut aufkl√§rung 	OTHER	OTHER
Da ist wohl der vielf√§ltige CO2-neutrale und fair gehandelte Prosecco bei einigen wieder oben rausgekommen Gl√ºckwunsch nach Hamburg an unsere MitstreiterüôÇ 	OTHER	OTHER
Laschet ist schlecht f√ºr unser Land gut f√ºr die AfD So ist es Malte Linksau√üen Laschet unterwirft sich dem politischen Islam Ob Ditib oder Salafisten etcNur die AfD steht f√ºr konsequente IslamkritikCDU AKKR√ºcktritt AKK Merkel Th√ºringen Kemmerich 	OFFENSE	OFFENSE
CarloMasala1 Es ist ganz einfach Wenn Parteien die auf die Wissenschaft h√∂ren bei Wahlen erfolgreich sind dann h√∂rt die Republik auf die Wissenschaft Oder aber wir reden √ºber eine moderne Variante des Philosophenk√∂nigtums Da bleibe ich doch lieber bei der guten alten FDGO	OTHER	OTHER
Bonjour  good morning Brussels On my way to the PES_PSE Ministers breakfast with PaoloGentiloni followed by the Council Meeting of Ministers for Europe On our agenda future relations EU-UK üá™üá∫üá¨üáß  enlargement preparation of next EUCO 	OTHER	OTHER
Ein echtes Gesetz f√ºr die Tonne der M√ºll den die neue Bon-Pflicht an einer Kasse in der Mensa des Bundestages in wenigen Stunden produziert Umweltschutz allesnurPropaganda 	OFFENSE	OFFENSE
Jahresempfang des Iserlohner Nordens Hennen Rheinen Rheinermark Dr√ºpplingsen Das Thema maroder Schwimmb√§der ist erkennbar nicht nur Thema im Sportausschuss des Bundestages 	OTHER	OTHER
Von Handwerksmeisterin bis Erzieherin Wir geben mehr Geld f√ºr Aufsteiger Das ist gute Politik baf√∂g meister wirmachendas ‚Å¶cducsubt‚Å© 	OTHER	OTHER
Welcome to AndrewLittleMP  Newsealand‚Äòs Minister of Justice  BMJV_Bund  Germany is one of the supporters of the Christchurch Call to eliminate terrorist and violent extremist content online üá≥üáø 	OTHER	OTHER
Menschen vor Profite Pflegenotstand stoppen Meine Rede vor dem Bundesgesundheitsministerium	OTHER	OTHER
SophiekochJ Schmanle Ich halte gern noch einmal fest dass wir aus guten Gr√ºnden die verschieden sind weder mit AfD noch Linken zusammenarbeiten Es gibt aber in der Kommunalpolitik so etwas wie eine Bagatellgrenze	OTHER	OTHER
Firmenbesuch bei OrionVersand Der Mittelst√§ndler ist der zweitgr√∂√üte Arbeitgeber im Landkreis Gie√üen Eine Industrie die l√§ngst die schmuddeligen Ecken hinter Bahnh√∂fen verlassen hat Allein Orion setzt heute j√§hrlich mehrere Millionen Euro in Deutschland um 	OTHER	OTHER
In vielen L√§ndern werden Minderj√§hrige als Kindersoldaten missbraucht Kinder sind keine Soldaten Deshalb setze ich am RedHandDay ein Zeichen gegen diese schreckliche Form der Gewalt gegen Kinder und Jugendliche Jeder hat ein Recht auf Kindheit 	OTHER	OTHER
Dass was wir in den letzten zehn Jahren im CSU-Verkehrsministerium erlebt haben ist v√∂llig aus dem Rahmen Da werden einfach ohne Sinn und Verstand Gelder f√ºr √ºberfl√ºssige Stra√üen rausgeballert einfach um lokale CSU-Abgeordnete zu befriedigenStra√üenbauwahnsinn NieMehrCSU 	OFFENSE	OTHER
Gr√ºne wie JTrittin fordern Einlagerung von Waffen in speziellen H√§usern Das war schon mal da- in der DDR  Die langen K√ºchenmesser noch dazu Nein Gefahr geht von illegalen Waffen und verzetteltenschwachen Beh√∂rden aus 	OTHER	OTHER
Puettmann_Bonn W√§re gern dabei gewesen Bis demn√§chst wieder einmal zum Kaffee Gr√º√üe	OTHER	OTHER
üòÇüòÇüòÇ 	OTHER	OTHER
matthias_herz sehr gutbitte macht so weiter	OTHER	OTHER
RepelTorman Sie k√∂nnen fordern was sie wollen Wenn die Forderungen grundlos sind interessiert das uns als AfD nicht	OTHER	OTHER
Ob Rechts- oder Linksextreme Beide attackieren Personen und sch√§digen Eigentum Beide sind eine Gefahr f√ºr die Demokratie und eine Bedrohung f√ºr das friedliche Zusammenleben Gegen Extremisten jeglicher Couleur m√ºssten Demokraten entschlossen vorgehen 	OFFENSE	OTHER
Das gelang auch schon fr√ºher problemlos Deutsche Demokratischeü§î Begriffe aush√∂hlen und umdeuten das geh√∂rt zum linken Standart 	OFFENSE	OTHER
SawsanChebli JoachimSt KonstantinKuhle katjadoerner Wie ist die SPD eigentlich auf diese Strategie gekommen	OFFENSE	OFFENSE
CoachJoerg Schade ich h√§tte gerne eine Antwort gehabt gerne mit Erl√§uterung zum Ja oder nein	OTHER	OTHER
 AfDwirkt  AKK = Angelas kleiner Klon = auch keine Kanzlerin AKKRuecktritt AKKR√ºcktritt ‚ñ∫ 	OFFENSE	OFFENSE
Ab heute beginnt die ENTGIFTUNG üòÄüòÉüòÄNoAfD	OFFENSE	OTHER
Freue mich schon auf die Aufnahmen wenn unser Superstar Steinmeier imAusland ein Stadion f√ºlltVermutlich im Iran 	OTHER	OTHER
Die Reaktion von Esken zeigt einmal wieder das grundlegende Missverst√§ndnis der SPD Steuern sind halt irgendwie da und k√∂nnen ausgegeben werden Tats√§chlich m√ºssen sie aber erst einmal erwirtschaftet werden‚Å¶cducsubt‚Å© ‚Å¶CDU‚Å© ‚Å¶csu_bt‚Å©  	OFFENSE	OTHER
√Ñhm wer regiert in Deutschland seit √ºber 70 Jahren Die Altparteien cdu spd fdp - mal so mal so Und inzwischen gr√ºne und linke ja auch schon ein Weilchen Wer ist also auch daf√ºr verantwortlichOder etwa die AfD weil sie zu sp√§t gegr√ºndet wurdeüòâ 	OTHER	OFFENSE
Erinnert irgendwie an die Titanic 	OTHER	OTHER
Wir d√ºrfen nicht nur √ºber Verantwortung reden sondern m√ºssen deutsche und europ√§ische Interessen klarer definieren Nur dann kann der Westen im 21 Jh bestehenGelungener Auftakt des ASP zur M√ºnchner Sicherheitskonferenz 2020 MSC2020ASPderCSU MunSecConf CarloMasala1 CSU 	OTHER	OTHER
Bin auf dem Weg zum Bundesverfassungsgericht 	OTHER	OTHER
minority stress = der Stress als Minderheit zu leben Dieser Stress kann krank machen und sozial ausgrenzen F√ºr diesen Stress ist nicht der Gestresste sondern die Gesellschaft verantwortlich die ihn aus√ºbt Eine politische Aufgabe 	OTHER	OFFENSE
Jetzt geht es los mit dem Fachgespr√§ch zu Clubsterben	OTHER	OTHER
TobiasBunde Sollen wir das mal bei Gelegenheit live diskutieren Vermutlich am sinnvollsten / spannendsten	OTHER	OTHER
Wie soll uns diese √úberschrift sagen Bauer verf√ºhrt KinderIch finde es gut wenn Landwirte erkl√§ren was Landwirtschaft hei√üt die Kuh nicht Lila ist das Ei produziert werden muss Da kann vielleicht ein veganer Lehrer noch was lernen Bauern_Verband 	OTHER	OTHER
Tolleüëç Besuchergruppe aus Th√ºringenGestern Abend in einer Berliner Kneipeüçª heute im und auf dem Reichstag - nette Menschenüßç‚Äç‚ôÇÔ∏èüßçüßç‚Äç‚ôÄÔ∏è gute Fragenü§î gute Gespr√§cheüó£ Danke üôè f√ºr den BesuchAfD AfDwirkt Berlin Bundestag Brandner 	OTHER	OTHER
√úber 1 Mio Software-Updates von Volkswagen und Daimler f√ºr schmutzige Diesel-Pkw fehlen nach wie vor Es ist dreist dass die Autohersteller die R√ºckrufe verschleppen und Minister Scheuer das tatenlos duldet Scheuer bleibt der Buddy der Autoindustrie	OFFENSE	OTHER
Gut so Strafanzeige gegen Generalbundesanwalt Frank ‚Äì nach Totalversagen in Sachen Hanau-M√∂rder 	OTHER	OTHER
Mangelhafte Rechtschreibung kein gravierendes Problem wegen Autokorrektur Diese Aussage ist inakzeptabel u menschenverachtend Unsere Kinder m√ºssen zu m√ºndigen B√ºrgern gebildet werden Oder haben die Gr√ºnen Angst von solchen B√ºrgern abgew√§hlt zu werden	OFFENSE	OFFENSE
W√§hrend in Berlin der Kongress Digitaler_Staat tagt staune ich √ºber die Antwort der BuReg auf meine KleineAnfrage zur Umstellung der Bundes IT von IPv4 auf IPv6 tldr Bund hat weder Ahnung vom Status Quo noch einen Plan Ausf√ºhrlicher auf meiner HP 	OTHER	OTHER
muenchner661 ZDFheute Doch er sagte etwas anderes n√§mlich dass man die 42% auf das gesamte Einkommen bezahlen muss Und das stimmt nun mal nicht	OTHER	OTHER
joheinen1 Ich lese in den wirtschaftspolitischen Empfehlungen der Staat solle massiv ins Gesundheitssystem in digitale Infrastruktur und √∂kologische Transformation investieren und die Teilabschaffung des Soli vorziehen F√ºr die EU empfiehlt man eine  gemeinschaftliche Krisenbew√§ltigung	OTHER	OTHER
Der Rechtsstaat funktioniert Das Bundesverfassungsgericht hat heute die Versammlungsfreiheit gegen zu strenge Corona-Ma√ünahmen hochgehalten Pauschale Freiheitseinschr√§nkungen sind immer schwieriger zu begr√ºnden - vor allem im Bereich der demokratischen Meinungsbildung fdpbt 	OTHER	OTHER
Ja was haben die rechten Trolle denn alle Robert Habeck sagt im Ton und Inhalt was zu sagen ist √ºber Trump Nationalisten und Chauvinisten wie er verdienen keine Solidarit√§t und Toleranz sondern klare Kante Davos 	OFFENSE	OTHER
fried_allers CarloMasala1 BMVg_Bundeswehr So wie es in der heutigen Pressemitteilung steht Wir schlagen deshalb vor hierzu eine Veranstaltungsreihe in allen Bundesl√§ndern durchzuf√ºhren und anschlie√üend eine Umfrage oder Abstimmung in der Bev√∂lkerung durchzuf√ºhren Denn die lehnt Killerdrohnen bekanntlich ab	OTHER	OTHER
Deutschlandstim EskenSaskia Gehts noch	OTHER	OTHER
Schw√∂r Frau Staatssekret√§r üòÇ chebli HamburgWahl 	OTHER	OTHER
Der Montag kann kommen Morgen startet wieder eine Sitzungswoche in Berlin Es gibt viel zu tunüí™Wir werden uns viele Gedanken machen m√ºssen wie wir die Wirtschaft st√§rken k√∂nnen Mit Verschw√∂rungstheorien m√∂chte ich mich aber diese Woche nicht mehr besch√§ftigen ‚úÖ cducsubt 	OTHER	OTHER
Verstehe weder sein Abstreiten noch die Aufregung _FriedrichMerz will Chef von CDU werden und pa√üt sich schonmal an den Sprachgebrauch an Alles im Normbereich Merz Gesindel AfD AfDimBundestag 	OFFENSE	OTHER
pleasebenottrue dieLinke Nennt sich R√ºckgrat - weil die AfD noch viel schlimmer ist	OFFENSE	OTHER
Beeindruckend schockierend und gleichzeitig leider Alltag vieler Frauen in Deutschland 	OFFENSE	OTHER
Respekt vor meinem CDU-Wahlkreiskollegen Kees de Vries Haltung 	OTHER	OTHER
+++Gr√ºne Gesundheitspolitik+++Schon gewusst Verschw√∂rungstheorien und Rassismus f√∂rdern die Verbreitung von Viren so die Gr√ºnen-Abgeordnete Kordula Schulz-Asche Aha alles klar Corona Covid19 AfD 	OTHER	OFFENSE
SteffenBilger Irre	OTHER	OFFENSE
AnneWill Christoph von Marschall Jetzt lassen wir mal die ganze Ideologie weg mit den europ√§ischen √ñlkonzeren die Krieg um √ñl f√ºhren und erg√§nzt dann ganz unideologisch dass Russland in Libyen kein Interesse an Frieden hat Ganz sachliche Analyse bravo	OFFENSE	OTHER
Insbesondere in √∂konomisch schwachen und in Krisenregionen nimmt geschlechtsspezifische Gewalt gegen Frauen* zu Support f√ºr die Demonstrantinnen 	OTHER	OFFENSE
bobhealy5 KlausMu97675009 AfD ARDde ZDF ulfposh Wenn die Aussage so gemeint war was ich nicht annehme ist sie aufs Sch√§rfste zu verurteilen Ebenso wie √ºbrigens die totalit√§ren √∂kosozialistischen Gedankenspiele im Umfeld der Gr√ºnen und Linken	OFFENSE	OTHER
KH_Paque FNFreiheit fdp fdpbt ArnoEsch reinholdmdb PreislerKa LindaTeuteberg franksitta theliberalfrank fdpdresden üëáüèª 	OTHER	OTHER
19Frank63 Auch das wurde geregelt	OTHER	OTHER
HollsteinM Interessiert das dann nicht nur die Berliner Blase ü§î	OTHER	OTHER
Schau mal an die Parlamentsbuchhandlung in der Berliner Wilhelmstra√üe hat das gro√üartige Buch von kuebra im Schaufenster u neben der Kasse Gute Wahl Und ja das ist eine Kauf- u Leseempfehlung 	OTHER	OTHER
ErbPatrick AfDimBundestag Junge_Freiheit üòÇüòÇüòÇ Okay der war gut	OTHER	OTHER
TorpedoMitte 	OTHER	OTHER
Vollst√§ndige Pressemitteilung hier	OTHER	OTHER
_danielkerekes Er hat schon ab und an richtig gute Reden gehalten hier war sie bitter notwendig nach all dem M√ºll	OFFENSE	OFFENSE
Waren Gensing Restle Hayali  Co nebst Entouragen eigentlich auch in Kassel bei den Linke|n Wann kommen deren bekannt kritischen Berichteüò§/ Ergebnisseü§¨/ Reportagenü§Ø Bin gespannt Staatsfunkü§•Nee war ein Scherzchenüòâ	OFFENSE	OTHER
Wie wahrLinke Gr√ºne SPD FDPHeimat Deutschland Merkel 	OTHER	OFFENSE
Wenn Ihr schon immer wissen wolltet wie wir ticken wobei das eher mein b√∂ser Blick ist - 	OTHER	OTHER
Und unser Genosse Klaus Baltruschad verlor seinen ArmDas Ganze hat eine Vorgeschichte an die ich mich in den vergangenen Tagen immer wieder erinnerteDamals wollten √ºbrigens Polizei Justiz Innensenator auch nicht die Nazinetzwerke aufkl√§ren Einzelt√§ter war schnell gesetzt 	OFFENSE	OTHER
Ganz sicher nicht Dieses krude Demokratieverst√§ndnis der Linken zeigt dass sie keine normale Partei ist Wir w√§hlen keinen linken Ministerpr√§sidenten CDU 	OTHER	OFFENSE
maischberger SawsanChebli DasErste Ach diese Frau Chebli die Twitter blockiert hat 	OTHER	OFFENSE
ZeGrumpyGerman violine1909 Nicht mal bei 4580 brutto sondern bei 4850 zu versteuerndem Einkommen pro Monat	OTHER	OTHER
HPZ53xx joachimgauckcom In Deutschland mochten viele - verst√§ndlicherweise - nach dem Krieg nicht sagen dass sie stolz w√§ren Deutsche zu sein Hat nichts mit anderen zu tun sondern mit der eigenen Geschichte Die Generation unserer Kinder kennt das kaum noch Das Vaterland ist Teil der Nationalhymne	OTHER	OTHER
Das Unsagbare soll wieder sagbar Antisemitismus salonf√§hig gemacht werden Es ist unser aller Aufgabe dies zu verhindernOder wie BPr Steinmeier es heute gesagt hatUnsere deutsche Verantwortung vergeht nicht Ihr wollen wir gerecht werden An ihr sollt ihr uns messen	OTHER	OTHER
juergenhardt im Interview zur MSC2020 Deutschland hat in den vergangenen Jahren Erhebliches geleistet  tr√§gt beachtliche internationale Verantwortung ‚Äì im diplomatischen im sicherheitspolitischen und auch im entwicklungspolitischen Bereich ‚û°Ô∏è 	OTHER	OTHER
Bodo Ramelow hat keine Mehrheit in Th√ºringen Das ist Fakt Und das war schon am Wahlabend um 18 Uhr Fakt Aber so etwas kann die selbsterkl√§rte und offensichtliche Nachfolgepartei der SED nat√ºrlich nicht akzeptieren	OFFENSE	OTHER
Gewalt als Mittel der politischen Auseinandersetzung geht gar nicht Wir m√ºssen mit aller Konsequenz und H√§rte gegen rechts- und linksradikale Gewaltt√§ter vorgehen 	OFFENSE	OFFENSE
MoellerAfD OTZonline Huch Pl√∂tzlich stehst ja Du statt Robby im Artikel Die sind ganz sch√∂n flexibelü§•ü§•ü§•	OFFENSE	OTHER
Wir werden eine Arbeitsgruppe einrichtenJetzt verh√∂hnt c_lindner von der fdpbt alle intelligenten Menschen im Lande - und das ganz ohne die Hilfe der AfDGrosses Kino 	OFFENSE	OTHER
GruenClaudia wilke_tobias Alle CDU-Mitglieder die ich kenne gro√üe Mehrzahl ist nach 1989 eingetreten √ºbrigens sind sich da sehr bewu√üt Ich kenne keine Fans von Herr G√∂tting bspw - aber viele Mitglieder der DDR-CDU haben gegen die Windm√ºhlenfl√ºgel der SED F√ºhrungsanspruch DDR-Verfassung gestritten	OFFENSE	OTHER
Nicht alle M√§nner bel√§stigen Frauen Doch Sexismus geht uns alle an - als Gesellschaft Jeden und jede von uns Also Hinschauen statt hinnehmen Ansprechen statt ignorieren und tabuisieren   Respekt statt Sexismus ‚ÄºÔ∏èm√§nnerwelten 	OTHER	OTHER
Die Menschen die in der Kohle gearbeitet haben oder noch arbeiten wissen selbst dass es mit dieser Energieform zu Ende gehen wird Wichtig Sie zu h√∂ren zu sehen und zu respektieren verbrecherei 	OFFENSE	OFFENSE
Zu Dresden Das Leid war unermesslich Der Alliierten-Angriff auf eine Stadt voller Fl√ºchtlinge ein Kriegsverbrechen Warum sagt ihr das nicht liebe Medien Mut zur Wahrheit	OFFENSE	OFFENSE
Resonanzkatast1 Atomreisfleisch ColognePride Die Abk√ºrzung steht f√ºr Lesben Schwule Bisexuelle Trans* und Inter*	OTHER	OFFENSE
Hier √ºbrigens ein Bild mit dem Gewinner Danke mxhbk f√ºr die tolle Idee und den Besuch im Bundestag TL 	OTHER	OTHER
Hier in Berlin wenn man gut zuh√∂rt h√∂rt man bereits das How dare you aus dem Kanzleramtüòú TS	OTHER	OTHER
beimwort Von Ausnahmen wie der aktuellen Stunden diesen Freitag abgesehen Die meisten Bundestagsdebatten sind deutlich inhaltlicher differenzierter und niveauvoller als die meisten Politik-Talkshows bei ARD und ZDF PS Und Nazis sind leider bei beiden dabei	OFFENSE	OFFENSE
RebHarms Volker_Beck _FriedrichMerz Die_Gruenen GrueneBundestag Du hast v√∂llig recht Mea culpa Landkommunen die tech-start-ups der 80er üíö	OTHER	OFFENSE
F√ºr Gewalt und √ºbelste Beleidigungen gegen Politiker gibt es keine Rechtfertigung Wir d√ºrfen es nicht zulassen dass Debatten durch Gewalt ersetzt werden Alle Demokraten m√ºssen hier zusammenstehen 	OTHER	OTHER
Jim1panse Da das Innenministerium nicht in FDP-Hand liegt k√∂nnen wir Ihnen das nicht beantworten Ansonsten gerne mal nachschauen welche Organisationen und Gruppierungen der Verfassungsschutz beobachtet TB	OTHER	OTHER
DerUrBerliner Es stimmt der Verkauf der GSW durch den damaligen Senat war ein Fehler Aber nicht vergessen	OTHER	OTHER
Zusammenhalt statt Spaltung Das gilt f√ºr unsere politische Kommunikation CDU Neben innovativen Konzepten und Formaten brauchen wir Botschaften Das macht uns stark digicCDU 	OTHER	OTHER
+++ Liebe B√ºrgerliche Falls noch nicht geschehen sollten Sie dringend in Hamburg w√§hlen gehen Die AfD braucht jede Stimme Wir sind die einzige Kraft die dem rotgr√ºnschwarzgelben Murks der Linksextremisten noch etwas Einhalt gebieten kann +++nurnochAfD	OFFENSE	OFFENSE
SBachTax OliverArentz Der Beitrag ist wirklich sehr instruktiv zeigt aber m E Das Gegenteil wie einfach es w√§re und wieviel Infos Daten und Praxen st√§dtebaulichen Vertrag es bereits gibt	OTHER	OTHER
Das ist f√ºr CDU und FDP auch eine Quittung f√ºr Th√ºringen Wer mit Faschisten paktiert wird abgestraftHamburgWahl	OTHER	OFFENSE
Glaubt eigentlich noch irgendjemand daran dass die Beh√∂rden im In- und Ausland die konkrete Planung von Anschl√§gen durch Amri und Djihadisten in seinem engsten Umfeld nicht kannten Der UA1BT hat Zweifel und wird auch die Verbindungen nach Frankreich intensiv untersuchen 	OTHER	OTHER
josefheynckes Zuviel Messwein erwischt - immer nur einen Kelchüòá	OTHER	OTHER
Religionen 40 Zeugen Jehovas halten einen elektronischen Wachturm auf einem tablet in die H√∂he Gesehen heute am Bhf Potsdamer Platz Ich musste 2 Mal hingucken	OTHER	OTHER
Robert_Kiesel HolgerKrestel FDPFraktionBLN AfDFraktionAGH fdp_berlin Ach herrje Herr Kiesel Ein wenig unter Ihrem Niveau CM	OFFENSE	OFFENSE
BorisTiger1 dieLinke Das ist echt krass	OFFENSE	OFFENSE
Wenn Selbstsucht und Ich - Bezogenheit zur Maxime von Politik werden Wenn man nicht mehr daran denken will dass man mit allem was man tut auch Verantwortung f√ºr andere tr√§gt 	OTHER	OTHER
thehorstest WerteUnion Das ist das Problem wenn man in einem Netz aus selbst geschaffenen L√ºgen sitzt  und es pl√∂tzlich zum Schwur kommt Da muss man die tollsten Man√∂ver ausf√ºhren nur um in der Rolle zu bleiben Ich sage jetzt mal ganz dreist Kann uns in der AfD nicht passieren	OFFENSE	OTHER
Rolle r√ºckw√§rts statt Liegest√ºtzen und h√∂here Fehlertoleranz bei Diktaten  Angesichts von Terrorismus Extremismus und Migrantenkriminalit√§t brauchen wir leistungsf√§hige Polizisten Schluss mit falschen Zielvorgaben und Qualit√§tssenkung bei der Polizei	OTHER	OTHER
In der aktuellen Ausgabe der Zeitschrift üá∫üá≥VEREINTE NATIONEN habe ich eine Zwischenbilanz von üá©üá™Deutschlands Mitgliedschaft im UN-Sicherheitsrat gezogenHier gibt es ein paar Ausz√ºge Den ganzen Artikel gibt es bei der DGVN_de 	OTHER	OTHER
Besch√§mend GroKo lehnt Aufnahme von 5000 besonders schutzbed√ºrftigen Fl√ºchtlingen von den griechischen Inseln ab Wo bleibt die Menschlichkeit	OFFENSE	OTHER
Die mit der Erdogan verb√ºndeten Islamisten leisten in Syrien ganze Arbeit Die letzten verbliebenen Christen m√ºssen fliehen Hat die Partei mit dem hohen C im Namen dazu eine Meinung Wird es in Ankara thematisiert Macht die GroKo wirklich Druck Sayfo Assyrer Armenier 	OTHER	OTHER
Ralf_Stegner Ihre Partei wird heute die Mauersch√ºtzenpartei unterst√ºtzen welche auch noch den Mord an einem Prozent der Bev√∂lkerung fordert Sie m√ºssen vom Verfassungsschutz beobachtet werden	OFFENSE	OFFENSE
Der Uraltslogan freie Fahrt f√ºr freie B√ºrger entfaltet bis heute seine Wirkung Und CDU/CSU haben Panik vor der AfD und dem Zorn geschwindigkeitsbegeisterter M√§nner 	OFFENSE	OFFENSE
Was unsere TrumpVersteher bei der FAZ_NET bis heute nicht wahrhaben wollen DEN Westen nicht gibt es nicht mehr Trump hat die einst still erodierende Gemeinsamkeit von Ideen Interessen und Institutionen zwischen Europa  USA brutal aufgek√ºndigt   	OFFENSE	OTHER
mimimi noafd NazisRaus HHWahl 	OFFENSE	OFFENSE
MartinBraml synergiewende haucap JuliaKloeckner Ja Null - deshalb bin ich ja auch dagegen	OTHER	OTHER
Masthuhn Sie meinen also wenn in einer Kita siebenmal pro Jahr f√ºr eine Stunde arabische polnische tschechische Lieder gesunden werden dann wird unsere Kultur ersetzt TB	OTHER	OTHER
Djazdzewski Markus_Soeder spdde PS Er hat Trick Tick und Track gesagt	OTHER	OFFENSE
Nie wieder Faschismus - Die Vorsitzende der Fraktion Linksfraktion Amira_M_Ali erinnert mit diesen Worten die demokratischen Parteien an die Lehre aus der Naziherrschaft 	OTHER	OFFENSE
AlexiaStellar spdbt Aber als Faschist als Anti-Demokrat als jemand der Grundrechte einschr√§nken WILL als L√ºgner als Marionette 	OFFENSE	OFFENSE
AliKaanSevinc So ein Unsinn Ihr Dauer-Laschet-Bashing ist auch sehr durchschaubar Gl√ºcklicherweise zeigen auch die Umfragen dass NRW mit der derzeitigen Landesregierung auf dem richtigen Weg ist Gut dass die Menschen Kraft J√§ger etc abgew√§hlt haben	OFFENSE	OTHER
Die Kanzlerin ist wegSie konnte aus dem tiefsten Afrika die R√ºckg√§ngigmachung demokratischer Wahlen in Th√ºringen fordernDoch wenn üá©üá™ vor einer Virus-Epidemie stehtist sie vom Erdboden verschluckt WoistMerkel Verantwortungsverweigerung COVID2019 coronavirus CoronaVirusDE	OFFENSE	OTHER
Volker_Beck AndiScheuer der war gut	OTHER	OFFENSE
Times-Korrespondent olivernmoody √ºber meine Bundestags-Rede zu den zuk√ºnftigen Beziehungen der EU zu Gro√übritannien 	OTHER	OTHER
S_Charybdis Wegen der gro√üen Nachfrage aus Asien extrem gestiegen	OTHER	OTHER
Und er wills nicht glauben bis sie nachts vorm Haus sindDoch sie schlagen  sie pl√ºndern sie verhaften TausendAchtunddrei√üig Sachsenhausen Und dieses Heimweh ob's irgendwann vorbeigehtF√ºr das verlorene Land dort im gelobten Land Max Herre Weidel AnneWill	OTHER	OTHER
6/6 Die klimafreundliche Bahn-Infrastruktur muss schneller gebaut werdenüëâMein Vorschlag Lange Planfeststellungsverfahren bei der Elektrifizierung der Bahn fallen weg	OTHER	OTHER
Klagesspiegel Umso wichtiger ist es deutlich zu machen warum es so ist	OTHER	OTHER
Verr√ºckt c_lindner bleibt akk tritt zur√ºckü§∑üèª‚Äç‚ôÄÔ∏è Typisch Wie M√§nner wieder einmal Verantwortung √ºbernehmen	OFFENSE	OFFENSE
ManJalte anked bodoramelow Selbstverst√§ndlich habe ich es gesehen Es ist uns√§glich und menschenverachtend	OFFENSE	OFFENSE
Bei der Katastrophe in Idlib  Lage an der griechischen Grenzen nicht abschotten  wegschauen sondern mit humanit√§rer Hilfe  Kontingenten f√ºr besonders Schutzbed√ºrftige helfen und Druck f√ºr einen Waffenstillstand machen auch mit individuellen Sanktionen 	OTHER	OTHER
Verzweifelt bem√ºhen sich die Altparteien die AfD in die Antisemitismus-Ecke zu stellen W√§hrend wir dies gerade ablehnen machen sich wirklich Israelfeinde und Judenfeinde AlQuds in Berlin breit Oldtimer-Show weicht Demo von Judenhassern / Q 	OFFENSE	OTHER
KatjaKeul spd GrueneLtNds filizgreen Weil da einer wei√ü was die Kommunen bisher geleistet haben i d wir diese nicht einfach so √ºberfordern sollten Eigentlich ganz einfach ü§∑‚Äç‚ôÇÔ∏è	OTHER	OFFENSE
Merz glaubt dass man den Rechtsradikalismus am besten bek√§mpft indem man ihm nachgibt Dass  mehr H√§rte gegen missliebige Ausl√§nder das beste Mittel gegen Rechtsradikalismus istSollte Merz CDU Chef und gar Kanzler werden hat die AfD gewonnen	OFFENSE	OFFENSE
LadyBitchRay1 JA üôè	OTHER	OTHER
Augstein Die richtigen Quellen sind bei Infektionskrankheiten IMMER das rki_de  Ausserdem bzga_de  und die Gesundheitsministerien der L√§nder sowie lokal das zust√§ndige Gesundheitsamt und weltweit die WHO	OTHER	OTHER
Gibt es das Wort Gefl√ºchteter wirklich oder ist das nur eine Wortsch√∂pfung Orwellschen Neusprechs Versucht mal statt fl√ºchten-gefl√ºchtet-Gefl√ºchteter mit anderen Aktivverben wie trinken laufen oder genie√üen üò≥	OFFENSE	OTHER
hemicker Das erinnert mich an die alte G-3-Vorschrift Zur Schussabgabe ist die Rohrm√ºndung in Feind- oder Zielrichtung zu halten	OTHER	OTHER
Welche Konsequenz wird die Politik aus diesen Erkenntnissen ziehen Vermutlich keine denn beim √ñkosozialismus ging und geht es nie um die Umwelt Er ist nur ein Vehikel des sozialistischen Systemwechsels	OFFENSE	OTHER
Seit der HHWahl muss jedem klar geworden sein dass wir keinen √ñRR haben sondern einen GEZ finanzierten Staatsfunk Zeit f√ºr Ver√§nderung Zeit f√ºr die AfD	OFFENSE	OTHER
Das Geschw√§tzt von CDU CSU und FDP - Linke sind genauso wie Rechte - m√ºssen sie mal ihren B√ºrgermeistern und Kommunalpolitikern erz√§hlen die oftmals mit uns Linken-Kommunalpolitikern vor Ort etwas gegen die Rechten Rassismus und Antisemitismus tun Unvereinbarkeitsbeschluss 	OTHER	OTHER
Gilt das heute auch nochüòâ 	OTHER	OTHER
janboehm Die CDU braucht dich Die SPD w√ºrde wahrscheinlich ausnahmsweise auch eine Doppelmitgliedschaft tolerieren	OTHER	OTHER
RMN_PG Diether_Dehm ZaklinNastic Andi_Wagner AlexanderSNeu voglerk ZdebelHubertus Ja es gab keine Entschuldigung f√ºr die Strafanzeige sondern f√ºr das unabgestimmte Vorgehen Ein paar Leute wollen das halt gerne  f√ºr sich umdeuten	OTHER	OTHER
